LEAP, Day 2.  Evening.

"Okay, kids!" Michelle, the counselor in charge of the scavenger hunt option waves her hands to settle the crowd around you, before finally remembering her whistle.  A brief fweep sweeps through the room.  "Okay, does everyone have their list?  Everyone good?  Okay!  You have until 8:25 pm to find everything on your lists, return here, and show me your lists so I can check them.  So synchronise your watches ... are we all in sync?  Good!  Your time starts ... now!"

Michelle's whistle gives another sharp fweep, and the room practically empties as everyone else runs off to begin their hunt.

A Gift of Empathy
A Gift of Empathy by Textfyre
Copyright 2009 by Textfyre
Designed by Ian Finley
Written by Jon Ingold
Game Engine (FyreVM) by Jesse McGrew
Inform 7 Story Programming by Graeme Jefferis
Testing by ____
User Interface Programming by Thomas Lynge
Special thanks to Graham Nelson and Emily Short
for all of their hard work on Inform 7.
All rights reserved

First Floor Lobby West
This used to be the living room, back when Alexander Quaverley Jacobs, the eccentric old coot who donated this place to the university was still alive and the university was just starting up.  It's got a huge fireplace, and a big bay window looking out onto the front lawn.  It's also been painted completely white from floor to ceiling, so thickly that you're not sure if some of the molding is not actually just bubbles under the paint.  The info desk is back through the arch to the north, and the lobby continues, through another arch, to the west.

A large brass plaque has been fixed into the space over the fireplace.

>l
First Floor Lobby West
This used to be the living room, back when old AQJ was still alive and the university was just starting up.  It's got a huge fireplace, and a big bay window looking out onto the front lawn.  It's also been painted completely white from floor to ceiling, so thickly that you're not sure if some of the molding is not actually just bubbles under the paint.  The info desk is back through the arch to the north, and the lobby continues, through another arch, to the west.

A large brass plaque has been fixed into the space over the fireplace.

>x plaque
It's shaped like a shield, and commemorates the memory of Damon Rose, one of the founders of LEAP.  You remember him quite well from last year.  It was quite a shock to hear about the accident, and there was some question as to whether LEAP could go on without him.  His wife, Claudia Rose, is in charge of LEAP now, and making sure that the good work goes on.  She seems like a nice lady, but she's just not quite as present as old Damon Rose used to be.

>read plaque
It's shaped like a shield, and commemorates the memory of Damon Rose, one of the founders of LEAP.  You remember him quite well from last year.  It was quite a shock to hear about the accident, and there was some question as to whether LEAP could go on without him.  His wife, Claudia Rose, is in charge of LEAP now, and making sure that the good work goes on.  She seems like a nice lady, but she's just not quite as present as old Damon Rose used to be.

>x window
Normally you can see all of the front lawn spread out from here, but right now there've been temporary walls set up all over the lawn.

>look through window
You find nothing of interest.

* * *

LEAP, Day 2.  Evening.

"Okay, kids!" Michelle, the counselor in charge of the scavenger hunt option waves her hands to settle the crowd around you, before finally remembering her whistle.  A brief fweep sweeps through the room.  "Okay, does everyone have their list?  Everyone good?  Okay!  You have until 8:25 pm to find everything on your lists, return here, and show me your lists so I can check them.  So synchronise your watches ... are we all in sync?  Good!  Your time starts ... now!"

Michelle's whistle gives another sharp fweep, and the room practically empties as everyone else runs off to begin their hunt.

A Gift of Empathy
A Gift of Empathy by Textfyre
Copyright 2009 by Textfyre
Designed by Chris Huang
Written by Paul O'Brien
Game Engine (FyreVM) by Jesse McGrew
Inform 7 Story Programming by Graeme Jefferis
Testing by ____
User Interface Programming by Thomas Lynge
Special thanks to Graham Nelson and Emily Short
for all of their hard work on Inform 7.
All rights reserved

First Floor Lobby, West
This used to be the living room, back when Alexander Quaverley Jacobs, the eccentric old coot who donated this place to the university was still alive and the university was just starting up.  It's got a huge fireplace, and a big bay window looking out onto the front lawn.  It's also been painted completely white from floor to ceiling, so thickly that you're not sure if some of the molding is not actually just bubbles under the paint.  The info desk is back through the arch to the north, and the lobby continues, through another arch, to the west.

A large brass plaque has been fixed into the space over the fireplace.

* * *

LEAP, Day 2.  Evening.

"Okay, kids!" Michelle, the counselor in charge of the scavenger hunt option waves her hands to settle the crowd around you, before finally remembering her whistle.  A brief fweep sweeps through the room.  "Okay, does everyone have their list?  Everyone good?  Okay!  You have until 8:25 pm to find everything on your lists, return here, and show me your lists so I can check them.  So synchronize your watches... are we all in sync?  Good!  Your time starts... now!"

Michelle's whistle gives another sharp fweep, and the room practically empties as everyone else runs off to begin their hunt.  Everyone except you: there's a sudden pressure in the back of your throat, and you feel dizzy ... it only lasts a moment, but by then everyone else is gone, leaving you alone.

The Empath's Gift
The Empath's Gift by Textfyre
Copyright 2010 by Textfyre
Designed by Paul O'Brian
Written by Christopher Huang
Game Engine (FyreVM) by Jesse McGrew
Inform 7 Programming by Ron Newcomb
 and Graeme Jefferis
Testing by ____
Special thanks to Graham Nelson and Emily Short
for all of their hard work on Inform 7.
All rights reserved.

Info Desk
The main foyer of Jacobs Hall still looks a bit like the inside of a hundred-year-old mansion, though it's been a little bit beat up by the passing generations of students.  The information desk, an anomaly in glass and polished steel, sits beneath a portrait of Alexander Quaverley Jacobs, facing the main entrance to the west.  To the east, wide double doors open onto Calvin Field, while arches go south and southeast to the rest of the lobby area.  Much of the north wall has been chewed through to make a connection to the newer part of Jacobs Hall.

Michelle Close leans against the side of the desk, chewing on a pencil.

>e
First Floor Lobby East
This used to be a rather large dining room, once upon a time, and it still has a low-hanging chandelier right in the middle of the ceiling.  A piano's been pushed under the chandelier so that nobody accidentally gets a head full of crystal walking blindly around, and the place is generally used as a kind of music room now.  The info desk is back to the northwest, and to the west is the rest of the first floor lobby.  Wide picture windows looks out on the front lawn and on the southern part of Calvin Field.

>w
You can't go that way.

* * *

>e
First Floor Lobby East
This used to be a rather large dining room, once upon a time, and it still has a low-hanging chandelier right in the middle of the ceiling.  A piano's been pushed under the chandelier so that nobody accidentally gets a head full of crystal walking blindly around, and the place is generally used as a kind of music room now.  The info desk is back to the northwest, and to the west is the rest of the first floor lobby.  Wide picture windows looks out on the front lawn and on the southern part of Calvin Field.

>nw
You can't go that way.

>ne
Info Desk
The main foyer of Jacobs Hall still looks a bit like the inside of a hundred-year-old mansion, though it's been a little bit beat up by the passing generations of students.  The information desk, an anomaly in glass and polished steel, sits beneath a portrait of Alexander Quaverley Jacobs, facing the main entrance to the west.  To the east, wide double doors open onto Calvin Field, while arches go south and southeast to the rest of the lobby area.  Much of the north wall has been chewed through to make a connection to the newer part of Jacobs Hall.

>s
First Floor Lobby, West
This used to be the living room, back when old AQJ was still alive and the university was just starting up.  It's got a huge fireplace, and a big bay window looking out onto the front lawn.  It's also been painted completely white from floor to ceiling, so thickly that you're not sure if some of the molding is not actually just bubbles under the paint.  The info desk is back through the arch to the north, and the lobby continues, through another arch, to the west.

A large brass plaque has been fixed into the space over the fireplace.

* * *

>x list
A newspaper
A feather
A flag
A star
A dinosaur
A hat
Something that was once alive

>inv
You are carrying: 
  a list of items for the Scavenger Hunt

* * *

>x dollar
You see nothing special about the few dollar notes.

>inv
You are carrying: 
  a list of items for the Scavenger Hunt
  a few dollar notes

* * *

>test
>--> The following tests are available:
'test walkthrough'
'test 1'
'test 2'
'test 3'
'test 4'
'test 5'
'test 6'
'test 7'
'test 8'
'test 9'
'test 10'

* * *

>goals
Goals Accomplished: 
  winning the scavenger hunt

Goals Remaining: 
  visit Ava & Stacy

>test
>--> The following tests are available:
'test walkthrough'
'test 1'
'test 2'
'test 3'
'test 4'
'test 5'
'test 6'
'test 7'
'test 8'
'test 9'
'test 10'

>restart
Are you sure you want to restart?

>y
It's your second year at the LEAP summer camp, and so far it's been as great as you remember last year to have been.  Ava Winters and Stacy Alexander, whom you met last year (and whom your brother Aidan calls "your girlfriends", much to your embarrassment) are here again.  You spent yesterday catching up on the news in between options and classes, and now you're settling in with the smug sensation of not being a raw newbie any more.

The LEAP summer camp isn't quite the same as most summer camps.  LEAP is an acronym for "Learning Enrichment Activity Program"; the brainchild of world-renowned educator Professor Damon Rose, it is housed on the campus of the University of Colorado at Valmont, and was created for Gifted and Talented Kids (gosh, that sounds impressive) to expand their horizons and encourage them to stretch their mental capabilities.

Whatever. That's all in the promotional flyers. You just know that you're in for two weeks of the sort of interesting classes you don't get in school, and a bunch of fun options with which to fill up the free time after classes.  This evening, for instance, you've signed up for a scavenger hunt....
LEAP, Day 2.  Evening.

"Okay, kids!" Michelle, the counselor in charge of the scavenger hunt option waves her hands to settle the crowd around you, before finally remembering her whistle.  A brief fweep sweeps through the room.  "Okay, does everyone have their list?  Everyone good?  Okay!  You have until 8:25 pm to find everything on your lists, return here, and show me your lists so I can check them.  So synchronize your watches... are we all in sync?  Good!  Your time starts... now!"

Michelle's whistle gives another sharp fweep, and the room practically empties as everyone else runs off to begin their hunt.  Everyone except you: there's a sudden pressure in the back of your throat, and you feel dizzy ... it only lasts a moment, but by then everyone else is gone, leaving you alone.

The Empath's Gift
The Empath's Gift by Textfyre
Copyright 2010 by Textfyre
Designed by Paul O'Brian
Written by Christopher Huang
Game Engine (FyreVM) by Jesse McGrew
Inform 7 Programming by Ron Newcomb and Graeme Jefferis
Testing by Paul O'Brian, Christopher Huang, and Eric Eve
Special thanks to Graham Nelson and Emily Short
for all of their hard work on Inform 7.
All rights reserved.

Info Desk
The main foyer of Jacobs Hall still looks a bit like the inside of a hundred-year-old mansion, though it's been a little bit beat up by the passing generations of students.  The information desk, an anomaly in glass and polished steel, sits beneath a portrait of Alexander Quaverley Jacobs, facing the main entrance to the west.  To the east, wide double doors open onto Calvin Field, while arches go south and southeast to the rest of the lobby area.  Much of the north wall has been chewed through to make a connection to the newer part of Jacobs Hall.

Michelle Close leans against the side of the desk, chewing on a pencil.

>tet walkthrough
That's not a verb I recognize.

* * *

>transcript
Attempt to begin transcript failed.

* * *

I beg your pardon?

>restart
Are you sure you want to restart?

* * *

>x flyer
[placeholder text: "leap flyers"]

.

>get flyer
You take a LEAP camp flyer.

>get flyer
You already have that.

>x flyer
[placeholder text: "One leap flyer"]

.

>x flyers
[placeholder text: "leap flyers"]

.

* * *

>x flyer
missing description.

>get flyer
You take a LEAP camp flyer.

>x it
Welcome to LEAP!

LEAP (Learning Enrichment Activity Program) is a summer camp like no other, focussed on stimulating intelligent young minds with a variety of fun activities and classes not offered in the normal educational curriculum.  The brainchild of the late Professor Damon Rose, LEAP is hosted by the University of Colorado at Valmont and benefits from the same facilities and amenities as the students of the university, including a world-renown library, state-of-the-art technology, and some of the best educational experts the world has to offer....

(The flyer goes on rather a bit about all the wonderful things you could experience here.  Most of it is even true, as you and your brother Aidan have had the pleasure of discovering over your time here.  And there's also a little bit at the back about Damon Rose, who died in an accident some months ago.  His sister, Dr Claudia Rose, is currently in charge of the program, though only temporarily: she's a medical research specialist, not an educator.  It will be a while before the University can find a really suitable replacement for old Damon Rose.) .

>fold it
You already have that.

You ponder making an origami LEAP camp flyer.

* * *

>get flyer
You take a LEAP camp flyer.

>x it
Welcome to LEAP!

LEAP (Learning Enrichment Activity Program) is a summer camp like no other, focussed on stimulating intelligent young minds with a variety of fun activities and classes not offered in the normal educational curriculum.  The brainchild of the late Professor Damon Rose, LEAP is hosted by the University of Colorado at Valmont and benefits from the same facilities and amenities as the students of the university, including a world-renown library, state-of-the-art technology, and some of the best educational experts the world has to offer....

(The flyer goes on rather a bit about all the wonderful things you could experience here.  Most of it is even true, as you and your brother Aidan have had the pleasure of discovering over your time here.  And there's also a little bit at the back about Damon Rose, who died in an accident some months ago.  His sister, Dr. Claudia Rose, is currently in charge of the program, though only temporarily: she's a medical research specialist, not an educator.  It will be a while before the University can find a really suitable replacement for old Damon Rose.).

>fold it
You fold the flyer into a boat.  Or is it a hat?  It's hard to tell, but given that it's too small to wear, it must be a boat.  A boat for very small people.

>fold it
It's already folded.

>unfold it
You unfold the LEAP camp flyer.

>fold it
It's already folded.

* * *

>read list
A newspaper
A feather
A flag
A star
A dinosaur
A hat
Something that was once alive

* * *

>x list
A newspaper
A feather
A flag
A star
A dinosaur
A hat
Something that was once alive

* * *

>restart
Are you sure you want to restart?

* * *

>z
Time passes.

>z
Time passes.

>x list
A newspaper
A feather
A flag
A star
A dinosaur
A hat
Something that was once alive

[New goals were added. Type GOALS to see them all]

>restart
Are you sure you want to restart?

* * *

>x list
A newspaper
A feather
A flag
A star
A dinosaur
A hat
Something that was once alive

>z
Time passes.

[New goals were added. Type GOALS to see them all]

* * *

>s
First Floor Lobby, West
This used to be the living room, back when Alexander Quaverley Jacobs, the eccentric old coot who donated this place to the university was still alive and the university was just starting up.  It's got a huge fireplace, and a big bay window looking out onto the front lawn.  It's also been painted completely white from floor to ceiling, so thickly that you're not sure if some of the molding is not actually just bubbles under the paint.  The info desk is back through the arch to the north, and the lobby continues, through another arch, to the west.

A large brass plaque has been fixed into the space over the fireplace.

>e
First Floor Lobby, East
This used to be a rather large dining room, once upon a time, and it still has a low-hanging chandelier right in the middle of the ceiling.  A piano's been pushed under the chandelier so that nobody accidentally gets a head full of crystal walking blindly around, and the place is generally used as a kind of music room now.  The info desk is back to the northwest, and to the west is the rest of the first floor lobby.  Wide picture windows look out on the front lawn and on the southern part of Calvin Field. The School of Rock option is in progress here, jamming away in the upper decibels.

>nw
Info Desk
The main foyer of Jacobs Hall still looks a bit like the inside of a hundred-year-old mansion, though it's been a little bit beat up by the passing generations of students.  The information desk, an anomaly in glass and polished steel, sits beneath a portrait of Alexander Quaverley Jacobs, facing the main entrance to the west.  To the east, wide double doors open onto Calvin Field, while arches go south and southeast to the rest of the lobby area.  Much of the north wall has been chewed through to make a connection to the newer part of Jacobs Hall.

Michelle Close leans against the side of the desk, chewing on a pencil.

>w
You step out into the bright sunshine.

Second Avenue
Second Avenue runs north and south along the edge of a cliff: to the west is a sharp drop down (don't even try) onto the rooftops of the buildings along First Avenue, and beyond those are the jagged ridges of the Rockies.  Jacobs Hall -- the old part, anyway -- is open to the east, and its front lawn spreads out to the southeast.  You can also go northeast, squeezing around the newer part of Jacobs Hall to the courtyard beyond.

Conveniently, a bus shelter with a newspaper vending machine is almost directly outside the Hall.

>e
You leave behind the bright sunshine.

Info Desk
The main foyer of Jacobs Hall still looks a bit like the inside of a hundred-year-old mansion, though it's been a little bit beat up by the passing generations of students.  The information desk, an anomaly in glass and polished steel, sits beneath a portrait of Alexander Quaverley Jacobs, facing the main entrance to the west.  To the east, wide double doors open onto Calvin Field, while arches go south and southeast to the rest of the lobby area.  Much of the north wall has been chewed through to make a connection to the newer part of Jacobs Hall.

Michelle Close leans against the side of the desk, chewing on a pencil.

>ask michelle for change
"What do you want it for, Daniel?"

1. "Snacks!"
2. "Soda pop!"
3. "Coffee!"
4. "Newspaper!"

>4
"Newspaper!"

"Why Daniel, I am so very pleased that you're taking an interest in current events!"  She drops just enough change for the newspaper machine into your hand, and winks.  "At least, I'm sure that's why you want a newspaper, and it's not because of anything so silly as a scavenger hunt."

>ask michelle for change
"What do you want it for, Daniel?"

1. "Snacks!"
2. "Soda pop!"
3. "Coffee!"
4. "Newspaper!"

* * *

>4
"Newspaper!"

"Why Daniel, I am so very pleased that you're taking an interest in current events!"  She drops just enough change for the newspaper machine into your hand, and winks.  "At least, I'm sure that's why you want a newspaper, and it's not because of anything so silly as a scavenger hunt."

>e
You step out into the bright sunshine.

Calvin Field, North
Claremont Hall, to the north, looms over the entire length of Calvin Field, which continues to the south.  Jacobs Hall is back to the west, and the dining hall is to the east.  A fountain takes up space right where all the paths meet, so there usually aren't that many people running around and tearing up the grass.  Right now, though, there are several people running around, playing Myth Tag, and there's nothing the fountain can do about it.

>w
You leave behind the bright sunshine.

Info Desk
The main foyer of Jacobs Hall still looks a bit like the inside of a hundred-year-old mansion, though it's been a little bit beat up by the passing generations of students.  The information desk, an anomaly in glass and polished steel, sits beneath a portrait of Alexander Quaverley Jacobs, facing the main entrance to the west.  To the east, wide double doors open onto Calvin Field, while arches go south and southeast to the rest of the lobby area.  Much of the north wall has been chewed through to make a connection to the newer part of Jacobs Hall.

Michelle Close leans against the side of the desk, chewing on a pencil.

>ask michelle for change
"What do you want it for, Daniel?"

1. "Snacks!"
2. "Soda pop!"
3. "Coffee!"
4. "Newspaper!"

>e
You step out into the bright sunshine.

Calvin Field, North
Claremont Hall, to the north, looms over the entire length of Calvin Field, which continues to the south.  Jacobs Hall is back to the west, and the dining hall is to the east.  A fountain takes up space right where all the paths meet, so there usually aren't that many people running around and tearing up the grass.  Right now, though, there are several people running around, playing Myth Tag, and there's nothing the fountain can do about it.

* * *

>4
That's not a verb I recognize.

>w
You step out into the bright sunshine.

Second Avenue
Second Avenue runs north and south along the edge of a cliff: to the west is a sharp drop down (don't even try) onto the rooftops of the buildings along First Avenue, and beyond those are the jagged ridges of the Rockies.  Jacobs Hall -- the old part, anyway -- is open to the east, and its front lawn spreads out to the southeast.  You can also go northeast, squeezing around the newer part of Jacobs Hall to the courtyard beyond.

Conveniently, a bus shelter with a newspaper vending machine is almost directly outside the Hall.

* * *

>i
You are carrying:
  a feather
  a list of items for the Scavenger Hunt
  a few dollars

Goals Accomplished: 
  finding a feather

Goals Remaining: 
  find a newspaper
  find a flag
  find a star
  find a dinosaur
  find a hat
  find something that was once alive

>x list
A newspaper
A feather
A flag
A star
A dinosaur
A hat
Something that was once alive

[New goals were added. Type GOALS to see them all]

>i
You are carrying:
  a list of items for the Scavenger Hunt
  a few dollars

Goals: 
  find a newspaper
  find a feather
  find a flag
  find a star
  find a dinosaur
  find a hat
  find something that was once alive

* * *

>l
Info Desk
The main foyer of Jacobs Hall still looks a bit like the inside of a hundred-year-old mansion, though it's been a little bit beat up by the passing generations of students.  The information desk, an anomaly in glass and polished steel, sits beneath a portrait of Alexander Quaverley Jacobs, facing the main entrance to the west.  To the east, wide double doors open onto Calvin Field, while arches go south and southeast to the rest of the lobby area.  Much of the north wall has been chewed through to make a connection to the newer part of Jacobs Hall.

Michelle Close leans against the side of the desk, chewing on a pencil.

>s
First Floor Lobby, West
This used to be the living room, back when Alexander Quaverley Jacobs, the eccentric old coot who donated this place to the university was still alive and the university was just starting up.  It's got a huge fireplace, and a big bay window looking out onto the front lawn.  It's also been painted completely white from floor to ceiling, so thickly that you're not sure if some of the molding is not actually just bubbles under the paint.  The info desk is back through the arch to the north, and the lobby continues, through another arch, to the west.

A large brass plaque has been fixed into the space over the fireplace.

* * *

>get dinosaur
You take a plastic dinosaur.

* * *

>read list
A newspaper
A feather
A flag
A star
A dinosaur
A hat
Something that was once alive

>s
First Floor Lobby, West
This used to be the living room, back when Alexander Quaverley Jacobs, the eccentric old coot who donated this place to the university was still alive and the university was just starting up.  It's got a huge fireplace, and a big bay window looking out onto the front lawn.  It's also been painted completely white from floor to ceiling, so thickly that you're not sure if some of the molding is not actually just bubbles under the paint.  The info desk is back through the arch to the north, and the lobby continues, through another arch, to the west.

A large brass plaque has been fixed into the space over the fireplace.

[New goals were added. Type GOALS to see them all]

>e
First Floor Lobby, East
This used to be a rather large dining room, once upon a time, and it still has a low-hanging chandelier right in the middle of the ceiling.  A piano's been pushed under the chandelier so that nobody accidentally gets a head full of crystal walking blindly around, and the place is generally used as a kind of music room now.  The info desk is back to the northwest, and to the west is the rest of the first floor lobby.  Wide picture windows look out on the front lawn and on the southern part of Calvin Field. The School of Rock option is in progress here, jamming away in the upper decibels.

>take dinosaur
You take a plastic dinosaur.

[You achieved a goal! (finding a dinosaur)]

>i
You are carrying:
  a plastic dinosaur
  a list of items for the Scavenger Hunt
  a few dollars

Goals Accomplished: 
  finding a dinosaur

Goals Remaining: 
  find a newspaper
  find a feather
  find a flag
  find a star
  find a hat
  find something that was once alive

* * *

I beg your pardon?

>e
First Floor Lobby, East
This used to be a rather large dining room, once upon a time, and it still has a low-hanging chandelier right in the middle of the ceiling.  A piano's been pushed under the chandelier so that nobody accidentally gets a head full of crystal walking blindly around, and the place is generally used as a kind of music room now.  The info desk is back to the northwest, and to the west is the rest of the first floor lobby.  Wide picture windows look out on the front lawn and on the southern part of Calvin Field. The School of Rock option is in progress here, jamming away in the upper decibels.

>x piano
Ava says it's a baby grand, and she knows more about this sort of thing.  All grand pianos seem more or less alike to you.  The pile of plastic dinosaurs under the piano probably makes it unique, however.

* * *

>x pile
Rarrr.  They're all very lifelike, despite being small, plastic, and a variety of colors unlikely to be found in nature.

>take dinosaur
You take a plastic dinosaur.

[You achieved a goal! (finding a dinosaur)]

>take dinosaur
You already have that.

* * *

>ask michelle for change
"What do you want it for, Daniel?"

1. "Snacks!"
2. "Soda pop!"
3. "Coffee!"