(This game is equipped with a simple help system. Type help to learn more about Interactive Fiction.)

When the monks took me, aged six months, into their care, they named me Wren. Maybe because I was small, insignificant, and happy to eat any crumbs they threw my way. But these days I'm Wren, 2nd Assistant Clock Polisher... and that's a role that's about as important in the workings of the Cathedral of Time as the large deaf man who re-stretches the worn-out springs.

"HEY WREN!"

Uh-oh.

"We've got a job for you!"

"Yeah, a promotion!"

This, coming from Drake and Calvin, means something horrible is about to happen.

"You've got your rag, don't you?"

"And your polish?"

"Yes," I bleat, holding up the glass tumbler they've given me.

"Course you do. Well, we've got something for you to do."

"Yeah," chimes Calvin.

One on each arm, they march me down the hall, towards the Abbot's door. Am I in trouble? Going to be thrown out of the Cathedral?

"On three!" shouts Drake.

"Tick!" Calvin counts. "Tick! Tock!"

They shove me through the door. I fall into the Abbot's personal chamber. I might not know much about the Abbey but I do know that I really shouldn't be in here.

The Shadow In The Cathedral
The Shadow In The Cathedral by Textfyre Inc
Version 1.2.20091119
Copyright 2009 by Textfyre Inc
Designed by Ian Finley
Written by Jon Ingold
Game Engine (FyreVM) by Jesse McGrew
Inform 7 Story Programming by Graeme Jefferis and Jon Ingold
Custom Library Messages extension by David Fisher
Testing by Jon Ingold, Ian Finley, Paul O'Brian,
Eric Eve, and Peter Berman
Special thanks to Graham Nelson and Emily Short
for all of their hard work on Inform 7.
All rights reserved

Abbot's Quarters
If I thought Abbots lived in luxury, then I was dead wrong. Even my attic's cozier than this. The Abbot's got no furniture at all, except a desk and a cot, and no decoration except for a bust of St. Newton. None of the axle-mounted, bevelled mobiles I was expecting. There's barely even any sunlight: one thin window to catch the sunrise, opposite the door to the hallway back west.

St. Newton is staring at the Abbot's unpolished Grandfather clock with a severe frown.

>inv
I am carrying:
  my lucky clock key (being worn)
  a rag
  a tumbler
    a small amount of polish

"And don't come out till that clock's shining!" shouts Drake from the hall.

"Yeah," Calvin says. "It's got to look as good as if we did it!"

"Idiot," Drake mutters. "Come on."

Their voices disappear down the hall.

>wave
You wave, feeling foolish.

* * *

>inv
I am carrying:
  my lucky clock key (being worn)
  a rag
  a tumbler
    a small amount of polish

"And don't come out till that clock's shining!" shouts Drake from the hall.

"Yeah," Calvin says. "It's got to look as good as if we did it!"

"Idiot," Drake mutters. "Come on."

Their voices disappear down the hall.

>remove key
You take off my lucky clock key.

* * *

>inv
I am carrying:
  my lucky clock key (being worn)
  a rag
  a tumbler
    a small amount of polish

"And don't come out till that clock's shining!" shouts Drake from the hall.

"Yeah," Calvin says. "It's got to look as good as if we did it!"

"Idiot," Drake mutters. "Come on."

Their voices disappear down the hall.

>rules
Rules tracing now switched on. Type "rules off" to switch it off again, or "rules all" to include even rules which do not apply.

>inv
[Rule "print empty inventory rule" applies.]
    [Rule "print standard inventory rule" applies.]
You are carrying:
  my lucky clock key (being worn)
  a rag
  a tumbler

    [Rule "use inventory to set pronouns rule" applies.]
    [Rule "report other people taking inventory rule" applies.]

>drop all
rag:     [Rule "can't drop yourself rule" applies.]
    [Rule "can't drop what's already dropped rule" applies.]
    [Rule "can't drop what's not held rule" applies.]
    [Rule "can't drop clothes being worn rule" applies.]
    [Rule "can't drop if this exceeds carrying capacity rule" applies.]
    [Rule "standard dropping rule" applies.]
    [Rule "standard report dropping rule" applies.]
Dropped.
tumbler:     [Rule "can't drop yourself rule" applies.]
    [Rule "can't drop what's already dropped rule" applies.]
    [Rule "can't drop what's not held rule" applies.]
    [Rule "can't drop clothes being worn rule" applies.]
    [Rule "can't drop if this exceeds carrying capacity rule" applies.]
    [Rule "standard dropping rule" applies.]
    [Rule "standard report dropping rule" applies.]
Dropped.

>inv
[Rule "print empty inventory rule" applies.]
    [Rule "print standard inventory rule" applies.]
You are carrying:
  my lucky clock key (being worn)

    [Rule "use inventory to set pronouns rule" applies.]
    [Rule "report other people taking inventory rule" applies.]

>rules off
Rules tracing now switched off. Type "rules" to switch it on again.

>get all
tumbler: Taken.
rag: Taken.
Bust of St Newton: Taken.

* * *

>inv
I am carrying:
  my lucky clock key (being worn)
  a rag
  a tumbler
    a small amount of polish

"And don't come out till that clock's shining!" shouts Drake from the hall.

"Yeah," Calvin says. "It's got to look as good as if we did it!"

"Idiot," Drake mutters. "Come on."

Their voices disappear down the hall.

>x key
The one thing I've had all my life. It's been there, on a string around my neck, for as long as I can remember. I keeping hoping that it's a last gift from my true family, and one day it'll open a treasure-chest or the door of one of the Great Houses. But then again, maybe it's just something I tried to eat as a baby. Either way, I've yet to find a lock it'll turn or a clock it'll wind.

>x string
You see nothing special about the string.

>showme
Abbot's Quarters - room
    yourself - person
        my lucky clock key (worn)
            string (part of my lucky clock key)
        rag
        tumbler - open container
    Bust of St Newton
    Abbot Gubbler's Grandfather clock

>open clock
(my lucky clock key)
That's not something you can open.

>open grandfather clock
That's not something you can open.

* * *

>inv
I am carrying:
  my lucky clock key (being worn)
  a rag
  a tumbler
    a small amount of polish

"And don't come out till that clock's shining!" shouts Drake from the hall.

"Yeah," Calvin says. "It's got to look as good as if we did it!"

"Idiot," Drake mutters. "Come on."

Their voices disappear down the hall.

>take me
You are always self-possessed.

* * *

>inv
I am carrying:
  my lucky clock key (being worn)
  a rag
  a tumbler
    a small amount of polish

"And don't come out till that clock's shining!" shouts Drake from the hall.

"Yeah," Calvin says. "It's got to look as good as if we did it!"

"Idiot," Drake mutters. "Come on."

Their voices disappear down the hall.

>get me
I am always self-possessed.

* * *

>inv
I am carrying:
  my lucky clock key (being worn)
  a rag
  a tumbler
    a small amount of polish

"And don't come out till that clock's shining!" shouts Drake from the hall.

"Yeah," Calvin says. "It's got to look as good as if we did it!"

"Idiot," Drake mutters. "Come on."

Their voices disappear down the hall.

>close tumbler
That's not something you can close.

The grandfather clock ticks off a minute with a stately thunk. Quickly, I make the sign of the winding gear.

>polish clock
I whisper the correct mantra against the evils of Friction and Dust, and start polishing. This'll take forever!

From the hallway outside comes the echo of voices. Too shaky to be Calvin or Drake. More like - oh, no. It's the Abbot, coming back to his room. And if he finds me here, then my springs won't be worth the spindles they're sprung to…

>hide
You must supply a noun.

The Abbot's voice is getting closer. The old man may move slower than a short hand, but he's definitely coming this way.

>hide under desk
The space under the cot is too small for me! Somewhere else, and quick!

Oh, widdershins! Gubbler is right outside the door! I'd better hide!

>hide in clock
"We'll talk in here," I hear the Abbot saying, from right outside the door. "More private. More quiet. Much better." The old man steps inside the room, followed by a tall figure in grey. In the last tick before his old eyes can see me, I dive inside the gigantic clock case and pull closed the door.

Inside Clock Case
As the phrase goes, I'm stuck between a rack and a gear-trace; except here I'm in the narrow gap between the clock case door and the heavy swinging penduluum behind. And if that hit me, and disrupted the holy timings… well, there's no way they wouldn't notice when the clock-hands stopped moving, let's just say.

A little light shines in through the keyhole, which is almost covered by the Abbot's spare robe.

Oh, no… That click outside was the sound of the Abbot closing the door. Looks like he - and the grey figure I glimpsed with him - are going to be here for a while…

>listen at keyhole
I only understood you as far as wanting to listen.

>listen to keyhole
You hear nothing unexpected.

* * *

>inv
I am carrying:
  my lucky clock key (being worn)
  a rag
  a tumbler
    a small amount of polish

"And don't come out till that clock's shining!" shouts Drake from the hall.

"Yeah," Calvin says. "It's got to look as good as if we did it!"

"Idiot," Drake mutters. "Come on."

Their voices disappear down the hall.

>jump
I jump on the spot, fruitlessly.

The grandfather clock ticks off a minute with a stately thunk. Quickly, I make the sign of the winding gear.

>look under clock
I find nothing of interest.

From the hallway outside comes the echo of voices. Too shaky to be Calvin or Drake. More like - oh, no. It's the Abbot, coming back to his room. And if he finds me here, then my springs won't be worth the spindles they're sprung to…

>hide
What do I want to hide under?

>bed
I can't see any such thing.

>oops cot
The space under the cot is too small for me! Somewhere else, and quick!

The Abbot's voice is getting closer. The old man may move slower than a short hand, but he's definitely coming this way.

>enter bed
I can't see any such thing.

>oops cot
No thanks. It looks horribly uncomfortable. And coming from me, considering where I sleep, that's really saying something.

Oh, widdershins! Gubbler is right outside the door! I'd better hide!

>enter clock
"We'll talk in here," I hear the Abbot saying, from right outside the door. "More private. More quiet. Much better." The old man steps inside the room, followed by a tall figure in grey. In the last tick before his old eyes can see me, I dive inside the gigantic clock case and pull closed the door.

Inside Clock Case
As the phrase goes, I'm stuck between a rack and a gear-trace; except here I'm in the narrow gap between the clock case door and the heavy swinging penduluum behind. And if that hit me, and disrupted the holy timings… well, there's no way they wouldn't notice when the clock-hands stopped moving, let's just say.

A little light shines in through the keyhole, which is almost covered by the Abbot's spare robe.

Oh, no… That click outside was the sound of the Abbot closing the door. Looks like he - and the grey figure I glimpsed with him - are going to be here for a while…

>polish penduluum with rag
To stop a clock is like murder. To shift the balance… that's something even worse still.

>pour
I didn't understand that sentence.

>sing
My singing is abominable.

* * *

>polish clock
I whisper the correct mantra against the evils of Friction and Dust, and start polishing. This'll take forever!

"And don't come out till that clock's shining!" shouts Drake from the hall.

"Yeah," Calvin says. "It's got to look as good as if we did it!"

"Idiot," Drake mutters. "Come on."

Their voices disappear down the hall.

>x lucky key
The one thing I've had all my life. It's been there, on a string around my neck, for as long as I can remember. I keeping hoping that it's a last gift from my true family, and one day it'll open a treasure-chest or the door of one of the Great Houses. But then again, maybe it's just something I tried to eat as a baby. Either way, I've yet to find a lock it'll turn or a clock it'll wind.

>x lucky clock key
The one thing I've had all my life. It's been there, on a string around my neck, for as long as I can remember. I keeping hoping that it's a last gift from my true family, and one day it'll open a treasure-chest or the door of one of the Great Houses. But then again, maybe it's just something I tried to eat as a baby. Either way, I've yet to find a lock it'll turn or a clock it'll wind.

>x key
The one thing I've had all my life. It's been there, on a string around my neck, for as long as I can remember. I keeping hoping that it's a last gift from my true family, and one day it'll open a treasure-chest or the door of one of the Great Houses. But then again, maybe it's just something I tried to eat as a baby. Either way, I've yet to find a lock it'll turn or a clock it'll wind.

>x clock
No wonder Calvin and Drake didn't want to do this. Abbot Gubbler's Grandfather clock is enormous: the face is the size of a dinnerplate and the cabinet below is big enough to be a wardrobe. Even just polishing the doors will take half an hour. The whole thing might take all day.

>l
Abbot's Quarters
If I thought Abbots lived in luxury, then I was dead wrong. Even my attic's cosier than this. The Abbot's got no furniture at all, except a desk and a cot, and no decoration except for a bust of St. Newton. None of the axle-mounted bevelled mobiles I was expecting. There's barely even any sunlight: one thin window to catch the sun-rise, opposite the door to the hallway back west.

St. Newton is staring at the Abbot's unpolished Grandfather clock with a severe frown.

>inv
You are carrying:
  my lucky clock key (being worn)
  a rag
  a tumbler

>showme
Abbot's Quarters - room
    yourself - person
        my lucky clock key (worn)
            string (part of my lucky clock key)
        rag
        tumbler - open container
    Bust of St. Newton
    Abbot Gubbler's Grandfather clock

>throw clock key at clock
(first taking my lucky clock key off)
Futile.

>l
Abbot's Quarters
If I thought Abbots lived in luxury, then I was dead wrong. Even my attic's cosier than this. The Abbot's got no furniture at all, except a desk and a cot, and no decoration except for a bust of St. Newton. None of the axle-mounted bevelled mobiles I was expecting. There's barely even any sunlight: one thin window to catch the sun-rise, opposite the door to the hallway back west.

St. Newton is staring at the Abbot's unpolished Grandfather clock with a severe frown.

>inv
You are carrying:
  my lucky clock key
  a rag
  a tumbler

>throw key at isaac
Futile.

* * *

>polish clock
I whisper the correct mantra against the evils of Friction and Dust, and start polishing. This'll take forever!

"And don't come out till that clock's shining!" shouts Drake from the hall.

"Yeah," Calvin says. "It's got to look as good as if we did it!"

"Idiot," Drake mutters. "Come on."

Their voices disappear down the hall.

>polish clock
I whisper the correct mantra against the evils of Friction and Dust, and start polishing. This'll take forever!

The grandfather clock ticks off a minute with a stately thunk. Quickly, I make the sign of the winding gear.

>polish clock
I whisper the correct mantra against the evils of Friction and Dust, and start polishing. This'll take forever!

From the hallway outside comes the echo of voices. Too shaky to be Calvin or Drake. More like - oh, no. It's the Abbot, coming back to his room. And if he finds me here, then my springs won't be worth the spindles they're sprung to…

>polish clock
If you think the Abbot will come in here, and say, "Oh, good, young Wren's polishing my clock," then you must have come unsprung. If he finds me here doing Calvin and Drakes work he'll have me declared unmechanistical and maybe even throw me out of the Abbey!

The Abbot's voice is getting closer. The old man may move slower than a short hand, but he's definitely coming this way.

>enter clock
You can't, since Abbot Gubbler's Grandfather clock is in the way.

Oh, widdershins! Gubbler is right outside the door! I'd better hide!

>undo
Abbot's Quarters
[Previous turn undone.]

>open clock
I open the clock door and peek inside. For a big clock it's got a pretty small penduluum, about the size of Calvin's fist and not as big as Drake's. There's even enough space in front of it for the Abbot to hang up one of his spare robes.

Oh, widdershins! Gubbler is right outside the door! I'd better hide!

>enter clock
Inside Clock Case
A little light shines in through the keyhole, which is almost covered by the Abbott's spare robe.

You can also see a robe, a penduluum and two counterweights here.

* * *

>polish clock
I whisper the correct mantra against the evils of Friction and Dust, and start polishing. This'll take forever!

"And don't come out till that clock's shining!" shouts Drake from the hall.

"Yeah," Calvin says. "It's got to look as good as if we did it!"

"Idiot," Drake mutters. "Come on."

Their voices disappear down the hall.

>polish bust
That seems clean enough as it is.

The grandfather clock ticks off a minute with a stately thunk. Quickly, I make the sign of the winding gear.

>w
Curses to counterweights! It's not on my rota, this clock, so why should I finish off my polish on it? I head for the doorway - then freeze. Voices, coming down the hall. It's the Abbot himself, coming this way!

>w
The Abbot's voice is getting nearer… If he sees I've been in here, he'll have me turning the paddles in the laundry room for a month! There's nothing for it, I'll have to escape.

The Abbot's voice is getting closer. The old man may move slower than a short hand, but he's definitely coming this way.

>hide
What do I want to hide under?

>hide in clock
"We'll talk in here," I hear the Abbot saying, from right outside the door. "More private. More quiet. Much better." The old man steps inside the room, followed by a tall figure in grey. In the last tick before his old eyes can see me, I dive inside the gigantic clock case and pull closed the door.

Inside Clock Case
As the phrase goes, I'm stuck between a rack and a gear-trace; except here I'm in the narrow gap between the clock case door and the heavy swinging penduluum behind. And if that hit me, and disrupted the holy timings… well, there's no way they wouldn't notice when the clock-hands stopped moving, let's just say.

A little light shines in through the keyhole, which is almost covered by the Abbot's spare robe.

Oh, no… That click outside was the sound of the Abbot closing the door. Looks like he - and the grey figure I glimpsed with him - are going to be here for a while…

>x abbot
I can't see much through the keyhole, except the Abbot's stout waist and shaking hands. Not much good for winding anything now, but if I said as much to anyone then I'd be in real trouble.

"I told you now didn't I tell you?" old Abbot Gubbler is saying, plaintively. "Here? Why here? You shouldn't have come here."

The Figure says something in reply. I can only hear two words, but they're enough to stop my heart. "Failure," and "Consequences."

>look through keyhole
I find nothing of interest.

"But these things, these things are not always tick-tock, they never are," the old man replies. His voice is quivering, quite different from the steady drone he has when intoning in Chapel. "The - item you asked about - it's in the Vaults, you see? The Vaults. Even if I could get in, I …"

The Figure is too far from the keyhole and speaks too quietly for me to hear clearly. "Disappointing," he says; and then "unslip your gears."

>put tumbler on keyhole
Oh… well, then. I tip out the last of the polish onto the floor of the clock. At least that part will shine.

I put the glass tumbler carefully against the door, then lean down to press my ear against it. Fantastic! I can hear much more clearly now!

The Abbot is spluttering and choking. You've seen him like this only once, when as a young initiate you dropped and smashed an altimeter right before the Archbishop was due to visit.

The Figure continues. "Clearly you're too old to steal the item for us. We have a better mechanism for obtaining it. But you must provide us with the opportunity. Is that understood?"

The Abbot nods violently, shaking out agreement the way I might beat dirt from a duster. "My money?" he asks.

>actions
Actions listing on.

>out
[exiting]
[(1) going outside]
I can't, since Gubbler's Grandfather clock is in the way.
[(1) going outside - failed the can't go through closed doors rule]

[exiting - failed the convert exit into go out rule]
There's the clink, of a pouch of golden minutes. A heavy pouch. The Figure, paying the Abbot…? Then suddenly, there's a third voice. "Sorry, Father, to interrupt, but you said…"

It's a monk of the Abbey. "Get out!" the Abbot screeches. His bearing's lost its oil, it seems. "Get out, get out!"

"But Father," the monk continues, "it's time, you know. You told me to tell you when it was time."

"Oh! Of course of course," he mumbles. "I'll… We'll continue this discussion later, then," he says, to the Figure.

"We certainly will," the Figure replies.

The Abbot leaves, and that leaves me alone, inside this clock, with the stranger outside. He's coming nearer… I can hear his fingers on the door of the case! I must have nudged the penduluum, he must have seen the clock-hands quiver… but then, there's the swish of his cloak as he moves away, and the click as the door closes. Phew.

>actions off
Actions listing off.

>out
I can't, since Gubbler's Grandfather clock is in the way.

>empty clock
That doesn't contain anything.

>l
Inside Clock Case
I'm leaning up against the door of the clock, with my ear pressed against the glass tumbler. The penduluum behind is like someone breathing in my ear. If I'm caught in here, I'm dead.

A little light shines in through the keyhole, which is almost covered by the Abbot's spare robe.

>open door
I open Gubbler's Grandfather clock.

>out
Abbot's Quarters
If I thought Abbots lived in luxury, then I was dead wrong. Even my attic's cosier than this. The Abbot's got no furniture at all, except a desk and a cot, and no decoration except for a bust of St. Newton. None of the axle-mounted bevelled mobiles I was expecting. There's barely even any sunlight: one thin window to catch the sun-rise, opposite the door to the hallway back west.

St. Newton is staring at the Abbot's unpolished Grandfather clock with a severe frown.

>empty newton
That doesn't contain anything.

>x window
The narrow-barred window catches the morning sunshine. The same sunshine that Drake and Calvin are out enjoying while I'm stuck in here.

>x bars
I can't see any such thing.

>listen
I hear nothing unexpected.

* * *

>polish clock
I whisper the correct mantra against the evils of Friction and Dust, and start polishing. This'll take forever!

"And don't come out till that clock's shining!" shouts Drake from the hall.

"Yeah," Calvin says. "It's got to look as good as if we did it!"

"Idiot," Drake mutters. "Come on."

Their voices disappear down the hall.

>open clock
I open the clock door and peek inside. For a big clock it's got a pretty small penduluum, about the size of Calvin's fist and not as big as Drake's. There's even enough space in front of it for the Abbot to hang up one of his spare robes.

The grandfather clock ticks off a minute with a stately thunk. Quickly, I make the sign of the winding gear.

>enter clock
I should polish the outside of the clock first, and that'll probably take more than long enough.

From the hallway outside comes the echo of voices. Too shaky to be Calvin or Drake. More like - oh, no. It's the Abbot, coming back to his room. And if he finds me here, then my springs won't be worth the spindles they're sprung to…

>enter clock
"We'll talk in here," I hear the Abbot saying, from right outside the door. "More private. More quiet. Much better." The old man steps inside the room, followed by a tall figure in grey. In the last tick before his old eyes can see me, I dive inside the gigantic clock case and pull closed the door.

Inside Clock Case
As the phrase goes, I'm stuck between a rack and a gear-trace; except here I'm in the narrow gap between the clock case door and the heavy swinging penduluum behind. And if that hit me, and disrupted the holy timings… well, there's no way they wouldn't notice when the clock-hands stopped moving, let's just say.

A little light shines in through the keyhole, which is almost covered by the Abbot's spare robe.

Oh, no… That click outside was the sound of the Abbot closing the door. Looks like he - and the grey figure I glimpsed with him - are going to be here for a while…

>z
Time passes.

"I told you now didn't I tell you?" old Abbot Gubbler is saying, plaintively. "Here? Why here? You shouldn't have come here."

The Figure says something in reply. I can only hear two words, but they're enough to stop my heart. "Failure," and "Consequences."

>listen with tumbler
Oh… well, then. I tip out the last of the polish onto the floor of the clock. At least that part will shine.

I put the glass tumbler carefully against the door, then lean down to press my ear against it. Fantastic! I can hear much more clearly now!

"But these things, these things are not always tick-tock, they never are," the old man replies. His voice is quivering, quite different from the steady drone he has when intoning in Chapel. "The - item you asked about - it's in the Vaults, you see? The Vaults. Even if I could get in, I …"

"Your excuses we find disappointing. Very disappointing. More of this and, Abbot, we may need to unslip your gears completely."

>out
You've got a spring missing if you think I can slip out, unnoticed, or come up with a decent excuse as to why I've been hiding in the Abbot's grandfather. No, I'm staying put and hoping nothing happens to make the old man need to change his clothes.

The Abbot is spluttering and choking. You've seen him like this only once, when as a young initiate you dropped and smashed an altimeter right before the Archbishop was due to visit.

The Figure continues. "Clearly you're too old to steal the item for us. We have a better mechanism for obtaining it. But you must provide us with the opportunity. Is that understood?"

The Abbot nods violently, shaking out agreement the way I might beat dirt from a duster. "My money?" he asks.

>z
Time passes.

There's the clink, of a pouch of golden minutes. A heavy pouch. The Figure, paying the Abbot…? Then suddenly, there's a third voice. "Sorry, Father, to interrupt, but you said…"

It's a monk of the Abbey. "Get out!" the Abbot screeches. His bearing's lost its oil, it seems. "Get out, get out!"

"But Father," the monk continues, "it's time, you know. You told me to tell you when it was time."

"Oh! Of course of course," he mumbles. "I'll… We'll continue this discussion later, then," he says, to the Figure.

"We certainly will," the Figure replies.

The Abbot leaves, and that leaves me alone, inside this clock, with the stranger outside. He's coming nearer… I can hear his fingers on the door of the case! I must have nudged the penduluum, he must have seen the clock-hands quiver… but then, there's the swish of his cloak as he moves away, and the click as the door closes. Phew.

>z
Time passes.

>out
I spill gratefully out of the clock, gasping for breath as though I've been underwater. I've just been holding it in, of course. As what I've heard - well, I probably shouldn't have, and the quicker I can get out of here, the better.

Abbot's Quarters
If I thought Abbots lived in luxury, then I was dead wrong. Even my attic's cosier than this. The Abbot's got no furniture at all, except a desk and a cot, and no decoration except for a bust of St. Newton. None of the axle-mounted bevelled mobiles I was expecting. There's barely even any sunlight: one thin window to catch the sun-rise, opposite the door to the hallway back west.

St. Newton is staring at the Abbot's unpolished Grandfather clock with a severe frown.

>w
(first opening the Abbot's Door)
I'm going to have to tell someone what I just heard. A theft, from the Vaults! But if the Abbot's involved - then who else might be? After all, the figure he was talking to could have been anyone in the Abbey!

Corridor of Contemplation
The ancient stones of the Abbey rise to about shoulder-height before arching over, forcing me to bow my head in supplication before the Abbot's door, back east. To the west, I can hear the gentle echo of ticks and tocks coming from the Abbey's main hall.

Carved into the walls are a series of pious engravings, depicting the long path from initiate to Abbot.

>w
Just in time, I see Drake's there. I hang back, to let him move on.

>w
I dart of the tunnel, only to be stopped dead by a depressing sight. It's Calvin and Drake, hurrying in through the Abbey's Great Entry. Their mouths are white with sugar.

"Hey, you!" Drake shouts. In a moment he's got me by the ear. "What were you doing in the Abbot's room? That's not on your rota!"

"Yeah!" Calvin adds. "And why are you slipping away when we told you to be there?"

"Idiot," Drake hisses. Louder - for the benefit of any passing monks - he says, "That's it, Wren. You're consigned to your room." For good measure, he punches me on the arm, then the two of them drag me away, heels over flagstones, right to the bottom of the ladder.

"Up you go," Calvin says. "And you're not to come down till dark!"

"What about dinner?" I ask.

"Should have thought of that, shouldn't you?" Drake says.

"More for us," Calvin adds. "Only two hours to go. I'm starved."

With that, they punch me again, and wait until I scurry away up the ladder.

Attic Room
This isn't really an attic. It isn't really a room either. It's a couple of floorboards laid across some roof rafters right in the ceiling of the Abbey. There's enough floor-space for a cot and a laundry crate, but I have to be careful not to roll out of bed, because if I do, the thick cobwebs all around aren't going to stop me from falling….

A little hole in the ceiling provides some sunlight: and when it rains, it means I can wash my hair, too. It's right above the rickety ladder down to the ground (and that means the ladder is starting to rot and bend).

Through my window I can see the Cathedral across the yard outside. If I was a bird, I could escape easily, and tell someone what I've overheard. The Abbot's about to do something terrible and I've got to stop him! Someone at the Cathedral would listen: the Archbishop himself, perhaps. He might remember me from the time he visited, when he helped me repair an altimeter I'd broken. If only I could fly.

But perhaps I can escape on foot. If I'm clever. Clockwise.

>d
I scramble quickly down the ladder.

Rickety Stair
I'm in one corner of the Great Hall, just by the foot of the ladder up to my room. There's a note attached to it, asking Amble the caretaker not to put it back in the shed just yet.

>e
Upper Hall
The Great Hall of the Abbey is the biggest room I've seen in my life, running from this end all the way southwest (and it is all the way, I'm never allowed further) to the Great Doors and the Yard outside. If I crane my neck I can see the dark square of the floorboards of my room - the ladder is on one side, to the west. Lights moves in and out overhead, from the candles moving on their Holy Tracks. Strong smells float through an archway to the east.

From their niches, the Three Major Saints are watching sternly, keen that I should get out of the Cathedral and talk to the Archbishop as quickly as possible.

>sw
Center Hall
I'm standing in the very centre of the Abbey's Great Hall. It's impossible not to crane my neck here, to gaze up at the ceiling held aloft by buttresses like gigantic oak trees. To think, people built this in the days before proper pulley-transmissions! It must have taken weeks! The hall continues northeast into shadow, and southwest, towards the sunlight, the Yard and above all, the Archbishop.

The vast empty space is filled by the muttering and echo of Holy Mechanisms, and the hiss of the candles as they sweep around their Tracks, providing a little light everywhere but rarely ever enough. I can just make out archways both east and west.

>z
Time passes.

Distantly - but not distantly enough - I can hear the clock and clatter of Drake's boots. The sounds coming from the northeast.

>z
Time passes.

Looking northeast, I can see Drake. He's coming this way!

>z
Time passes.

Drake arrives from the northeast.

>z
Time passes.

Drake goes southwest.

>z
Time passes.

Drake's on patrol, and I can hear him heading this way, from the west.

>z
Time passes.

Drake's just off to the west, and he's coming this way!

>w
Just in time, I see Drake's there. I hang back, to let him move on.

Drake arrives from the west.

>z
Time passes.

Drake goes east.

>z
Time passes.

>z
Time passes.

Drake's footsteps echo in from the northeast.

>z
Time passes.

Looking northeast, I can see Drake. He's coming this way!

>e
West Refectory
I spend some of my time here, eating at one of the two long tables. I spend even more serving the monks. Each of them has their own seat, marked by a little brass hourglass, and if the twenty or so I can see here weren't enough (which they aren't), there's more to the east, where the Refectory continues. Back west is the archway to the Great Hall.

On the table is a single empty teacup, left over from breakfast.

>z
Time passes.

>z
Time passes.

>z
Time passes.

Drake's clattering boots are audible to the west.

>w
I catch the sound of hobnailed boots. Drake's heading this way! I'd better wait, and let him pass.

Drake's just off to the west, and he's coming this way!

>e
East Refectory
The eastern end of the long Refectory is given over in part to the tables lined with brass hourglasses, but in the other half there's nothing but the enormous Refectory Clock. It's an impressive thing, so big because it only needs winding once a year, despite all the gongs, cymbals, tubes and bells that strike when dinner time comes around. Right now, the clock is showing the time at just after 3pm.

Pungent smells drift in from the kitchen to the north. On the east wall is the small green door to the Abbey's herb garden.

I've got a moment before Drake spots me: he's just appeared, to the west.

>n
Kitchen
If there was ever a proof of the perfection of Clockwork over Nature, it's that the dirtiest and most hectic room in the whole Abbey is its Kitchen. Shelves, walls and floor are covered by machines belching, slicing, steaming, chopping, stirring, boiling, broiling, frying, pureeing … the list goes on. The noise, smell and heat is almost overpowering, and the Cook, who controls this madhouse, can only stand it because he's stone deaf.

Drake's just off to the south, and he's coming this way!

>w
Upper Hall
The Great Hall of the Abbey is the biggest room I've seen in my life, running from this end all the way southwest (and it is all the way, I'm never allowed further) to the Great Doors and the Yard outside. If I crane my neck I can see the dark square of the floorboards of my room - the ladder is on one side, to the west. Lights moves in and out overhead, from the candles moving on their Holy Tracks. Strong smells float through an archway to the east.

From their niches, the Three Major Saints are watching sternly, keen that I should get out of the Cathedral and talk to the Archbishop as quickly as possible.

I've got a moment before Drake spots me: he's just appeared, to the east.

>w
Rickety Stair
I'm in one corner of the Great Hall, just by the foot of the ladder up to my room. There's a note attached to it, asking Amble the caretaker not to put it back in the shed just yet.

>e
Just in time, I see Drake's there. I hang back, to let him move on.

>e
Upper Hall
The Great Hall of the Abbey is the biggest room I've seen in my life, running from this end all the way southwest (and it is all the way, I'm never allowed further) to the Great Doors and the Yard outside. If I crane my neck I can see the dark square of the floorboards of my room - the ladder is on one side, to the west. Lights moves in and out overhead, from the candles moving on their Holy Tracks. Strong smells float through an archway to the east.

From their niches, the Three Major Saints are watching sternly, keen that I should get out of the Cathedral and talk to the Archbishop as quickly as possible.

>sw
Center Hall
I'm standing in the very centre of the Abbey's Great Hall. It's impossible not to crane my neck here, to gaze up at the ceiling held aloft by buttresses like gigantic oak trees. To think, people built this in the days before proper pulley-transmissions! It must have taken weeks! The hall continues northeast into shadow, and southwest, towards the sunlight, the Yard and above all, the Archbishop.

The vast empty space is filled by the muttering and echo of Holy Mechanisms, and the hiss of the candles as they sweep around their Tracks, providing a little light everywhere but rarely ever enough. I can just make out archways both east and west.

Drake's on patrol, and I can hear him heading this way, from the west.

>w
I catch the sound of hobnailed boots. Drake's heading this way! I'd better wait, and let him pass.

Drake's just off to the west, and he's coming this way!

>w
Just in time, I see Drake's there. I hang back, to let him move on.

Drake arrives from the west.

* * *

>polish clock
I whisper the correct mantra against the evils of Friction and Dust, and start polishing. This'll take forever!

"And don't come out till that clock's shining!" shouts Drake from the hall.

"Yeah," Calvin says. "It's got to look as good as if we did it!"

"Idiot," Drake mutters. "Come on."

Their voices disappear down the hall.

>l
Abbot's Quarters
If I thought Abbots lived in luxury, then I was dead wrong. Even my attic's cosier than this. The Abbot's got no furniture at all, except a desk and a cot, and no decoration except for a bust of St. Newton. None of the axle-mounted bevelled mobiles I was expecting. There's barely even any sunlight: one thin window to catch the sun-rise, opposite the door to the hallway back west.

St. Newton is staring at the Abbot's unpolished Grandfather clock with a severe frown.

The grandfather clock ticks off a minute with a stately thunk. Quickly, I make the sign of the winding gear.

>x st newton
I can feel the well-fitted eyes of St Newton gazing right down into my workings. Quickly, I make the sign of penduluum and look away.

From the hallway outside comes the echo of voices. Too shaky to be Calvin or Drake. More like - oh, no. It's the Abbot, coming back to his room. And if he finds me here, then my springs won't be worth the spindles they're sprung to…

>open clock
I open the clock door and peek inside. For a big clock it's got a pretty small penduluum, about the size of Calvin's fist and not as big as Drake's. There's even enough space in front of it for the Abbot to hang up one of his spare robes.

The Abbot's voice is getting closer. The old man may move slower than a short hand, but he's definitely coming this way.

>enter clock
"We'll talk in here," I hear the Abbot saying, from right outside the door. "More private. More quiet. Much better." The old man steps inside the room, followed by a tall figure in grey. In the last tick before his old eyes can see me, I dive inside the gigantic clock case and pull closed the door.

Inside Clock Case
As the phrase goes, I'm stuck between a rack and a gear-trace; except here I'm in the narrow gap between the clock case door and the heavy swinging penduluum behind. And if that hit me, and disrupted the holy timings… well, there's no way they wouldn't notice when the clock-hands stopped moving, let's just say.

A little light shines in through the keyhole, which is almost covered by the Abbot's spare robe.

Oh, no… That click outside was the sound of the Abbot closing the door. Looks like he - and the grey figure I glimpsed with him - are going to be here for a while…

>listen with tumbler
Oh… well, then. I tip out the last of the polish onto the floor of the clock. At least that part will shine.

I put the glass tumbler carefully against the door, then lean down to press my ear against it. Fantastic! I can hear much more clearly now!

"I told you now didn't I tell you?" old Abbot Gubbler is saying, plaintively. "Here? Why here? You shouldn't have come here."

The Figure says something in reply. With the glass, I can hear quite clearly. That was a good idea. "We have been disappointed with your failure. The cause and effect principle, Abbot. Such failure must bring consequences."

>z
Time passes.

"But these things, these things are not always tick-tock, they never are," the old man replies. His voice is quivering, quite different from the steady drone he has when intoning in Chapel. "The - item you asked about - it's in the Vaults, you see? The Vaults. Even if I could get in, I …"

"Your excuses we find disappointing. Very disappointing. More of this and, Abbot, we may need to unslip your gears completely."

>z
Time passes.

The Abbot is spluttering and choking. You've seen him like this only once, when as a young initiate you dropped and smashed an altimeter right before the Archbishop was due to visit.

The Figure continues. "Clearly you're too old to steal the item for us. We have a better mechanism for obtaining it. But you must provide us with the opportunity. Is that understood?"

The Abbot nods violently, shaking out agreement the way I might beat dirt from a duster. "My money?" he asks.

>z
Time passes.

There's the clink, of a pouch of golden minutes. A heavy pouch. The Figure, paying the Abbot…? Then suddenly, there's a third voice. "Sorry, Father, to interrupt, but you said…"

It's a monk of the Abbey. "Get out!" the Abbot screeches. His bearing's lost its oil, it seems. "Get out, get out!"

"But Father," the monk continues, "it's time, you know. You told me to tell you when it was time."

"Oh! Of course of course," he mumbles. "I'll… We'll continue this discussion later, then," he says, to the Figure.

"We certainly will," the Figure replies.

The Abbot leaves, and that leaves me alone, inside this clock, with the stranger outside. He's coming nearer… I can hear his fingers on the door of the case! I must have nudged the penduluum, he must have seen the clock-hands quiver… but then, there's the swish of his cloak as he moves away, and the click as the door closes. Phew.

>out
I spill gratefully out of the clock, gasping for breath as though I've been underwater. I've just been holding it in, of course. As what I've heard - well, I probably shouldn't have, and the quicker I can get out of here, the better.

Abbot's Quarters
If I thought Abbots lived in luxury, then I was dead wrong. Even my attic's cosier than this. The Abbot's got no furniture at all, except a desk and a cot, and no decoration except for a bust of St. Newton. None of the axle-mounted bevelled mobiles I was expecting. There's barely even any sunlight: one thin window to catch the sun-rise, opposite the door to the hallway back west.

St. Newton is staring at the Abbot's unpolished Grandfather clock with a severe frown.

* * *

>w
I dart of the tunnel, only to be stopped dead by a depressing sight. It's Calvin and Drake, hurrying in through the Abbey's Great Entry. Their mouths are white with sugar.

"Hey, you!" Drake shouts. In a moment he's got me by the ear. "What were you doing in the Abbot's room? That's not on your rota!"

"Yeah!" Calvin adds. "And why are you slipping away when we told you to be there?"

"Idiot," Drake hisses. Louder - for the benefit of any passing monks - he says, "That's it, Wren. You're consigned to your room." For good measure, he punches me on the arm, then the two of them drag me away, heels over flagstones, right to the bottom of the ladder.

"Up you go," Calvin says. "And you're not to come down till dark!"

"What about dinner?" I ask.

"Should have thought of that, shouldn't you?" Drake says.

"More for us," Calvin adds. "Only two hours to go. I'm starved."

With that, they punch me again, and wait until I scurry away up the ladder.

Attic Room
This isn't really an attic. It isn't really a room either. It's a couple of floorboards laid across some roof rafters right in the ceiling of the Abbey. There's enough floor-space for a cot and a laundry crate, but I have to be careful not to roll out of bed, because if I do, the thick cobwebs all around aren't going to stop me from falling….

A little hole in the ceiling provides some sunlight: and when it rains, it means I can wash my hair, too. It's right above the rickety ladder down to the ground (and that means the ladder is starting to rot and bend).

Through my window I can see the Cathedral across the yard outside. If I was a bird, I could escape easily, and tell someone what I've overheard. The Abbot's about to do something terrible and I've got to stop him! Someone at the Cathedral would listen: the Archbishop himself, perhaps. He might remember me from the time he visited, when he helped me repair an altimeter I'd broken. If only I could fly.

But perhaps I can escape on foot. If I'm clever. Clockwise.

* * *

>d
I scramble quickly down the ladder.

Rickety Stair
I'm in one corner of the Great Hall, just by the foot of the ladder up to my room. There's a note attached to it, asking Amble the caretaker not to put it back in the shed just yet.

>e
Upper Hall
The Great Hall of the Abbey is the biggest room I've seen in my life, running from this end all the way southwest (and it is all the way, I'm never allowed further) to the Great Doors and the Yard outside. If I crane my neck I can see the dark square of the floorboards of my room - the ladder is on one side, to the west. Lights move in and out overhead, from the candles moving on their Holy Tracks. Strong smells float through an archway to the east.

From their niches, the Three Major Saints are watching sternly, keen that I should get out of the Cathedral and talk to the Archbishop as quickly as possible.

>e
Kitchen
If there was ever a proof of the perfection of Clockwork over Nature, it's that the dirtiest and most hectic room in the whole Abbey is its Kitchen. Shelves, walls and floor are covered by machines belching, slicing, steaming, chopping, stirring, boiling, broiling, frying, pureeing … the list goes on. The noise, smell and heat is almost overpowering, and the Cook, who controls this madhouse, can only stand it because he's stone deaf.

I can escape back into the cool of the Hall to the west. South, through a broad arch, is the Refectory.

The cook knocks past me, to unclip the masher.

>x machines
Pipes run like cobwebs between a hundred fantastic devices. One entire corner is given over to automatic egg-boiling: "A Holy Problem of Timing," Gubbler once said. Other wires, pulleys, ducts, gears and cog-teeth cross the floor and ceiling, and the Cook is constantly sweeping muck and crumbs out from the mechanisms in a desperate attempt to keep them in good order.

>x tea machine
Very complex, but robustly built and able to perform its functions a few thousand times without needing to be oiled. It consists of a framework of arms and struts, most of which move, though there's a plate at the front to hold the primary gear-train that's between the lever and the winding key. Inside the machine I can make out a kettle, a spigot, and a basket suspended over a semi-circular bracket. There's a burner somewhere, too.

The cook bustles past me, to thump the oven.

Distantly - but not distantly enough - I can hear the clock and clatter of Drake's boots. The sound's coming from the south.

>get tea
(the tea leaves)
I scoop up a handful of tea leaves.

The cook pushes past me, to unclip the masher.

Looking south, I can see Drake. He's coming this way!

>w
Upper Hall
The Great Hall of the Abbey is the biggest room I've seen in my life, running from this end all the way southwest (and it is all the way, I'm never allowed further) to the Great Doors and the Yard outside. If I crane my neck I can see the dark square of the floorboards of my room - the ladder is on one side, to the west. Lights move in and out overhead, from the candles moving on their Holy Tracks. Strong smells float through an archway to the east.

From their niches, the Three Major Saints are watching sternly, keen that I should get out of the Cathedral and talk to the Archbishop as quickly as possible.

I've got a moment before Drake spots me: he's just appeared, to the east.

>s
I can't go that way.

"Wren!" Drake exclaims. He wallops me on the arm. "I thought I told you to stay in your room?" He doesn't wait for an excuse before I'm dragged off to the ladder. Then he waits - and wallops me - until I give in and climb all the way back up.

Attic Room
This isn't really an attic. It isn't really a room either. It's a couple of floorboards laid across some roof rafters right in the ceiling of the Abbey. There's enough floor-space for a cot and a laundry crate, but I have to be careful not to roll out of bed, because if I do, the thick cobwebs all around aren't going to stop me from falling….

A little hole in the ceiling provides some sunlight: and when it rains, it means I can wash my hair, too. It's right above the rickety ladder down to the ground (and that means the ladder is starting to rot and bend).

That was careless, getting caught. But I can still make it to the Cathedral. I'll just have to be more cunning this time. Remember, Wren, it's easy: the whole world runs on clockwork. Just a matter of staying ahead of the biting teeth.

>undo
Upper Hall
[Previous turn undone.]

>sw
Central Hall
I'm standing in the very centre of the Abbey's Great Hall. It's impossible not to crane my neck here, to gaze up at the ceiling held aloft by buttresses like gigantic oak trees. To think, people built this in the days before proper pulley-transmissions! It must have taken weeks! The hall continues northeast into shadow, and southwest, towards the sunlight, the Yard and above all, the Archbishop.

The vast empty space is filled by the muttering and echo of Holy Mechanisms, and the hiss of the candles as they sweep around their Tracks, providing a little light everywhere but rarely ever enough. I can just make out archways both east and west.

I've got a moment before Drake spots me: he's just appeared, to the northeast.

>w
Library
The Abbey's library is small compared to the one in the Cathedral. There's nothing on the shelves but the key texts: the Principia, the Mechanistica and the Determininium. Only Brother Horloge, the Abbey's Primary Reader ever seems to use them - he's here at the moment, studying at his desk by the poor light coming through the stained glass windows. By his elbow is a fat bunch of keys. On his shoulder is his mechanical owl, wings folded.

An archway leads east back into the hall. From the southwest comes the clatter of Writing hammers and the sharp smell of burnt ink.

Horloge looks up as I enter. "Ah, young - young Whotsit!" he bellows, pointing a fat finger in my general direction, though through his thick multi-lensed spectacles I don't think he can quite see where I am. "Look here!" he demands. "Young Whotsit-whoever-you-are! I need some - some of that, you know. Some of that whotsit. A good… of whotsit? Uh-huh? Good? Good." He smiles, then looks back down to his studies, muttering.

>z
Time passes.

Drake's clattering boots are audible to the southwest.

>e
Central Hall
I'm standing in the very centre of the Abbey's Great Hall. It's impossible not to crane my neck here, to gaze up at the ceiling held aloft by buttresses like gigantic oak trees. To think, people built this in the days before proper pulley-transmissions! It must have taken weeks! The hall continues northeast into shadow, and southwest, towards the sunlight, the Yard and above all, the Archbishop.

The vast empty space is filled by the muttering and echo of Holy Mechanisms, and the hiss of the candles as they sweep around their Tracks, providing a little light everywhere but rarely ever enough. I can just make out archways both east and west.

Drake's on patrol, and I can hear him heading this way, from the west.

>e
West Refectory
I spend some of my time here, eating at one of the two long tables. I spend even more serving the monks. Each of them has their own seat, marked by a little brass hourglass, and if the twenty or so I can see here weren't enough (which they aren't), there's more to the east, where the Refectory continues. Back west is the archway to the Great Hall.

On the table is a single empty teacup, left over from breakfast.

Drake's footsteps echo in from the west.

>get cup
I pick up the empty cup from its place beside by Brother Horloge's hourglass.

Looking west, I can see Drake. He's coming this way!

>e
East Refectory
The eastern end of the long Refectory is given over in part to the tables lined with brass hourglasses, but in the other half there's nothing but the enormous Refectory Clock. It's an impressive thing, so big because it only needs winding once a year, despite all the gongs, cymbals, tubes and bells that strike when dinner time comes around. Right now, the clock is showing the time at just after 3pm.

Pungent smells drift in from the kitchen to the north. On the east wall is the small green door to the Abbey's herb garden.

Drake's just off to the west, and he's coming this way!

>n
Kitchen
If there was ever a proof of the perfection of Clockwork over Nature, it's that the dirtiest and most hectic room in the whole Abbey is its Kitchen. Shelves, walls and floor are covered by machines belching, slicing, steaming, chopping, stirring, boiling, broiling, frying, pureeing … the list goes on. The noise, smell and heat is almost overpowering, and the Cook, who controls this madhouse, can only stand it because he's stone deaf.

The cook pushes past me, to unclip the grater.

I've got a moment before Drake spots me: he's just appeared, to the south.

>w
Upper Hall
The Great Hall of the Abbey is the biggest room I've seen in my life, running from this end all the way southwest (and it is all the way, I'm never allowed further) to the Great Doors and the Yard outside. If I crane my neck I can see the dark square of the floorboards of my room - the ladder is on one side, to the west. Lights move in and out overhead, from the candles moving on their Holy Tracks. Strong smells float through an archway to the east.

From their niches, the Three Major Saints are watching sternly, keen that I should get out of the Cathedral and talk to the Archbishop as quickly as possible.

Looking east, I can see Drake. He's coming this way!

>w
Rickety Stair
I'm in one corner of the Great Hall, just by the foot of the ladder up to my room. There's a note attached to it, asking Amble the caretaker not to put it back in the shed just yet.

* * *

>e
Just in time, I see Drake's there. I hang back, to let him move on.

>e
Upper Hall
The Great Hall of the Abbey is the biggest room I've seen in my life, running from this end all the way southwest (and it is all the way, I'm never allowed further) to the Great Doors and the Yard outside. If I crane my neck I can see the dark square of the floorboards of my room - the ladder is on one side, to the west. Lights move in and out overhead, from the candles moving on their Holy Tracks. Strong smells float through an archway to the east.

From their niches, the Three Major Saints are watching sternly, keen that I should get out of the Cathedral and talk to the Archbishop as quickly as possible.

>e
Kitchen
If there was ever a proof of the perfection of Clockwork over Nature, it's that the dirtiest and most hectic room in the whole Abbey is its Kitchen. Shelves, walls and floor are covered by machines belching, slicing, steaming, chopping, stirring, boiling, broiling, frying, pureeing … the list goes on. The noise, smell and heat is almost overpowering, and the Cook, who controls this madhouse, can only stand it because he's stone deaf.

>scenes
Scene 'Entire Game' playing (for 32 mins now)
Scene 'Introduction' ended 
Scene 'Hiding in the clock' ended 
Scene 'Quest for Tea' playing (for 12 mins now)
Scene 'Drake's Patrol' playing (for 21 mins now)
(Scene monitoring now switched on. Type "scenes off" to switch it off again.)

>scenes off
(Scene monitoring now switched off. Type "scenes" to switch it on again.)

>showme
Kitchen - room
    myself - person
        teacup
        Tea Machine
        my lucky clock key (worn)
        rag
        tumbler - open container
    Cook - man
    machines
    tea leaves - open container

* * *

>sw
Central Hall
I'm standing in the very centre of the Abbey's Great Hall. It's impossible not to crane my neck here, to gaze up at the ceiling held aloft by buttresses like gigantic oak trees. To think, people built this in the days before proper pulley-transmissions! It must have taken weeks! The hall continues northeast into shadow, and southwest, towards the sunlight, the Yard and above all, the Archbishop.

The vast empty space is filled by the muttering and echo of Holy Mechanisms, and the hiss of the candles as they sweep around their Tracks, providing a little light everywhere but rarely ever enough. I can just make out archways both east and west.

Drake's just off to the northeast, and he's coming this way!

>undo
Upper Hall
[Previous turn undone.]

>w
Rickety Stair
I'm in one corner of the Great Hall, just by the foot of the ladder up to my room. There's a note attached to it, asking Amble the caretaker not to put it back in the shed just yet.

>z
Time passes.

>e
Upper Hall
The Great Hall of the Abbey is the biggest room I've seen in my life, running from this end all the way southwest (and it is all the way, I'm never allowed further) to the Great Doors and the Yard outside. If I crane my neck I can see the dark square of the floorboards of my room - the ladder is on one side, to the west. Lights move in and out overhead, from the candles moving on their Holy Tracks. Strong smells float through an archway to the east.

From their niches, the Three Major Saints are watching sternly, keen that I should get out of the Cathedral and talk to the Archbishop as quickly as possible.

* * *

>e
Kitchen
If there was ever a proof of the perfection of Clockwork over Nature, it's that the dirtiest and most hectic room in the whole Abbey is its Kitchen. Shelves, walls and floor are covered by machines belching, slicing, steaming, chopping, stirring, boiling, broiling, frying, pureeing … the list goes on. The noise, smell and heat is almost overpowering, and the Cook, who controls this madhouse, can only stand it because he's stone deaf.

>sw
I can't go that way.

>w
Upper Hall
The Great Hall of the Abbey is the biggest room I've seen in my life, running from this end all the way southwest (and it is all the way, I'm never allowed further) to the Great Doors and the Yard outside. If I crane my neck I can see the dark square of the floorboards of my room - the ladder is on one side, to the west. Lights move in and out overhead, from the candles moving on their Holy Tracks. Strong smells float through an archway to the east.

From their niches, the Three Major Saints are watching sternly, keen that I should get out of the Cathedral and talk to the Archbishop as quickly as possible.

>sw
Just in time, I see Drake's there. I hang back, to let him move on.

>sw
Central Hall
I'm standing in the very centre of the Abbey's Great Hall. It's impossible not to crane my neck here, to gaze up at the ceiling held aloft by buttresses like gigantic oak trees. To think, people built this in the days before proper pulley-transmissions! It must have taken weeks! The hall continues northeast into shadow, and southwest, towards the sunlight, the Yard and above all, the Archbishop.

The vast empty space is filled by the muttering and echo of Holy Mechanisms, and the hiss of the candles as they sweep around their Tracks, providing a little light everywhere but rarely ever enough. I can just make out archways both east and west.

>w
Library
The Abbey's library is small compared to the one in the Cathedral. There's nothing on the shelves but the key texts: the Principia, the Mechanistica and the Determininium. Only Brother Horloge, the Abbey's Primary Reader ever seems to use them - he's here at the moment, studying at his desk by the poor light coming through the stained glass windows. By his elbow is a fat bunch of keys. On his shoulder is his mechanical owl, wings folded.

An archway leads east back into the hall. From the southwest comes the clatter of Writing hammers and the sharp smell of burnt ink.

Horloge looks up as I enter. "Ah, young - young Whotsit!" he bellows, pointing a fat finger in my general direction, though through his thick multi-lensed spectacles I don't think he can quite see where I am. "Look here!" he demands. "Young Whotsit-whoever-you-are! I need some - some of that, you know. Some of that whotsit. A good… of whotsit? Uh-huh? Good? Good." He smiles, then looks back down to his studies, muttering.

>e
Central Hall
I'm standing in the very centre of the Abbey's Great Hall. It's impossible not to crane my neck here, to gaze up at the ceiling held aloft by buttresses like gigantic oak trees. To think, people built this in the days before proper pulley-transmissions! It must have taken weeks! The hall continues northeast into shadow, and southwest, towards the sunlight, the Yard and above all, the Archbishop.

The vast empty space is filled by the muttering and echo of Holy Mechanisms, and the hiss of the candles as they sweep around their Tracks, providing a little light everywhere but rarely ever enough. I can just make out archways both east and west.

Looking northeast, I can see Drake. He's coming this way!

>e
West Refectory
I spend some of my time here, eating at one of the two long tables. I spend even more serving the monks. Each of them has their own seat, marked by a little brass hourglass, and if the twenty or so I can see here weren't enough (which they aren't), there's more to the east, where the Refectory continues. Back west is the archway to the Great Hall.

On the table is a single empty teacup, left over from breakfast.

>w
Just in time, I see Drake's there. I hang back, to let him move on.

>w
Central Hall
I'm standing in the very centre of the Abbey's Great Hall. It's impossible not to crane my neck here, to gaze up at the ceiling held aloft by buttresses like gigantic oak trees. To think, people built this in the days before proper pulley-transmissions! It must have taken weeks! The hall continues northeast into shadow, and southwest, towards the sunlight, the Yard and above all, the Archbishop.

The vast empty space is filled by the muttering and echo of Holy Mechanisms, and the hiss of the candles as they sweep around their Tracks, providing a little light everywhere but rarely ever enough. I can just make out archways both east and west.

Drake's on patrol, and I can hear him heading this way, from the west.

>be
That's not a verb I recognize.

>ne
Upper Hall
The Great Hall of the Abbey is the biggest room I've seen in my life, running from this end all the way southwest (and it is all the way, I'm never allowed further) to the Great Doors and the Yard outside. If I crane my neck I can see the dark square of the floorboards of my room - the ladder is on one side, to the west. Lights move in and out overhead, from the candles moving on their Holy Tracks. Strong smells float through an archway to the east.

From their niches, the Three Major Saints are watching sternly, keen that I should get out of the Cathedral and talk to the Archbishop as quickly as possible.

>e
Kitchen
If there was ever a proof of the perfection of Clockwork over Nature, it's that the dirtiest and most hectic room in the whole Abbey is its Kitchen. Shelves, walls and floor are covered by machines belching, slicing, steaming, chopping, stirring, boiling, broiling, frying, pureeing … the list goes on. The noise, smell and heat is almost overpowering, and the Cook, who controls this madhouse, can only stand it because he's stone deaf.

In one corner is the only machine I'm allowed to use: the Tea Maker. There's a jar of tea leaf beside it.

The cook bustles past me, to thump the steamer.

>get tea
(the tea leaves)
I take a couple more leaves.

Drake's clattering boots are audible to the south.

>w
Upper Hall
The Great Hall of the Abbey is the biggest room I've seen in my life, running from this end all the way southwest (and it is all the way, I'm never allowed further) to the Great Doors and the Yard outside. If I crane my neck I can see the dark square of the floorboards of my room - the ladder is on one side, to the west. Lights move in and out overhead, from the candles moving on their Holy Tracks. Strong smells float through an archway to the east.

From their niches, the Three Major Saints are watching sternly, keen that I should get out of the Cathedral and talk to the Archbishop as quickly as possible.

Drake's footsteps echo in from the east.

>w
Rickety Stair
I'm in one corner of the Great Hall, just by the foot of the ladder up to my room. There's a note attached to it, asking Amble the caretaker not to put it back in the shed just yet.

* * *

>e
Kitchen
If there was ever a proof of the perfection of Clockwork over Nature, it's that the dirtiest and most hectic room in the whole Abbey is its Kitchen. Shelves, walls and floor are covered by machines belching, slicing, steaming, chopping, stirring, boiling, broiling, frying, pureeing … the list goes on. The noise, smell and heat is almost overpowering, and the Cook, who controls this madhouse, can only stand it because he's stone deaf.

In one corner is the only machine I'm allowed to use: the Tea Maker. There's a jar of tea leaf beside it.

The cook pushes past me, to wind the crumb-sucker.

>inv
I am carrying:
  a handful of tea leaves
  my lucky clock key (being worn)
  a rag
  a tumbler

>x leaves
(the handful of tea leaves)
I see nothing special about the handful of tea leaves.

>remove tea from jar
I take a couple more leaves.

Drake's clattering boots are audible to the south.

>w
Upper Hall
The Great Hall of the Abbey is the biggest room I've seen in my life, running from this end all the way southwest (and it is all the way, I'm never allowed further) to the Great Doors and the Yard outside. If I crane my neck I can see the dark square of the floorboards of my room - the ladder is on one side, to the west. Lights move in and out overhead, from the candles moving on their Holy Tracks. Strong smells float through an archway to the east.

From their niches, the Three Major Saints are watching sternly, keen that I should get out of the Cathedral and talk to the Archbishop as quickly as possible.

Drake's on patrol, and I can hear him heading this way, from the east.

>w
Rickety Stair
I'm in one corner of the Great Hall, just by the foot of the ladder up to my room. There's a note attached to it, asking Amble the caretaker not to put it back in the shed just yet.

>inv
I am carrying:
  a handful of tea leaves
  my lucky clock key (being worn)
  a rag
  a tumbler

>drop tea
I scatter the tea leaves. They quickly disintegrate and are gone.

>inv
I am carrying:
  my lucky clock key (being worn)
  a rag
  a tumbler

>e
Upper Hall
The Great Hall of the Abbey is the biggest room I've seen in my life, running from this end all the way southwest (and it is all the way, I'm never allowed further) to the Great Doors and the Yard outside. If I crane my neck I can see the dark square of the floorboards of my room - the ladder is on one side, to the west. Lights move in and out overhead, from the candles moving on their Holy Tracks. Strong smells float through an archway to the east.

From their niches, the Three Major Saints are watching sternly, keen that I should get out of the Cathedral and talk to the Archbishop as quickly as possible.

>e
Kitchen
If there was ever a proof of the perfection of Clockwork over Nature, it's that the dirtiest and most hectic room in the whole Abbey is its Kitchen. Shelves, walls and floor are covered by machines belching, slicing, steaming, chopping, stirring, boiling, broiling, frying, pureeing … the list goes on. The noise, smell and heat is almost overpowering, and the Cook, who controls this madhouse, can only stand it because he's stone deaf.

In one corner is the only machine I'm allowed to use: the Tea Maker. There's a jar of tea leaf beside it.

>get tea
(the tea leaves)
I scoop up a handful of tea leaves.

>put tea in machine
(the handful of tea leaves in the Tea Machine)
I scatter the tea leaves. They quickly disintegrate and are gone.

The cook bustles past me, to thump the oven.

Drake's clattering boots are audible to the south.

>undo
Kitchen
[Previous turn undone.]

>put tea in jar
(the handful of tea leaves in the tea leaves)
I put the tea leaf back into the jar.

Drake's clattering boots are audible to the south.

>w
Upper Hall
The Great Hall of the Abbey is the biggest room I've seen in my life, running from this end all the way southwest (and it is all the way, I'm never allowed further) to the Great Doors and the Yard outside. If I crane my neck I can see the dark square of the floorboards of my room - the ladder is on one side, to the west. Lights move in and out overhead, from the candles moving on their Holy Tracks. Strong smells float through an archway to the east.

From their niches, the Three Major Saints are watching sternly, keen that I should get out of the Cathedral and talk to the Archbishop as quickly as possible.

Drake's footsteps echo in from the east.

* * *

>w
Rickety Stair
I'm in one corner of the Great Hall, just by the foot of the ladder up to my room. There's a note attached to it, asking Amble the caretaker not to put it back in the shed just yet.

>inv
I am carrying:
  my lucky clock key (being worn)
  a rag
  a tumbler

* * *

>get tea
(the tea leaves)
I scoop up a handful of tea leaves.

The cook pushes past me, to unclip the masher.

Looking south, I can see Drake. He's coming this way!

>under
That's not a verb I recognize.

>undo
Kitchen
[Previous turn undone.]

>showme
Kitchen - room
    myself - person
        my lucky clock key (worn)
        rag
        tumbler - open container
    Cook - man
    machines
    tea leaves - open container
    Tea Machine

* * *

>get tea
(the tea leaves)
I scoop up a handful of tea leaves.

The cook pushes past me, to unclip the masher.

Looking south, I can see Drake. He's coming this way!

>undo
Kitchen
[Previous turn undone.]

>get jar
That's hardly portable.

I've got a moment before Drake spots me: he's just appeared, to the south.

* * *

>put tumbler in basket
Tumbler-tea wouldn't go down well with anybody.

The cook knocks past me, to unclip the crumb-sucker.

>put polish in basket
I can't see any such thing.

>undo
Kitchen
[Previous turn undone.]

>inv
I am carrying:
  my lucky clock key (being worn)
  a rag

The cook scurries past me, to thump the crumb-sucker.

Distantly - but not distantly enough - I can hear the clock and clatter of Drake's boots. The sound's coming from the south.

>undo
Kitchen
[Previous turn undone.]

>put rag in basket
Rag-tea wouldn't go down well with anybody.

Distantly - but not distantly enough - I can hear the clock and clatter of Drake's boots. The sound's coming from the south.

>put cook in basket
I need to be holding the Cook before I can put it into something else.

The cook bustles past me, to unclip the crumb-sucker.

Looking south, I can see Drake. He's coming this way!

>w
Upper Hall
The Great Hall of the Abbey is the biggest room I've seen in my life, running from this end all the way southwest (and it is all the way, I'm never allowed further) to the Great Doors and the Yard outside. If I crane my neck I can see the dark square of the floorboards of my room - the ladder is on one side, to the west. Lights move in and out overhead, from the candles moving on their Holy Tracks. Strong smells float through an archway to the east.

From their niches, the Three Major Saints are watching sternly, keen that I should get out of the Cathedral and talk to the Archbishop as quickly as possible.

Drake's just off to the east, and he's coming this way!

>w
Rickety Stair
I'm in one corner of the Great Hall, just by the foot of the ladder up to my room. There's a note attached to it, asking Amble the caretaker not to put it back in the shed just yet.

* * *

>e
Kitchen
If there was ever a proof of the perfection of Clockwork over Nature, it's that the dirtiest and most hectic room in the whole Abbey is its Kitchen. Shelves, walls and floor are covered by machines belching, slicing, steaming, chopping, stirring, boiling, broiling, frying, pureeing … the list goes on. The noise, smell and heat is almost overpowering, and the Cook, who controls this madhouse, can only stand it because he's stone deaf.

The cook scurries past me, to wind the grater.

>put spigot in basket
I need to be holding the spigot before I can put it into something else.

The cook pushes past me, to respring the oven.

>put tumber in basket
I can't see any such thing.

>put tumbler in basket
I need to be holding the tumbler before I can put it into something else.

>get tumbler from basket
Taken.

The cook scurries past me, to thump the masher.

Drake's on patrol, and I can hear him heading this way, from the south.

* * *

>put tumbler in basket
Tumbler-tea wouldn't go down well with anybody.

The cook knocks past me, to unclip the crumb-sucker.

>put cook in basket
I need to be holding the Cook before I can put it into something else.

Distantly - but not distantly enough - I can hear the clock and clatter of Drake's boots. The sound's coming from the south.

>put me in basket
I need to be holding myself before I can put them into something else.

I've got a moment before Drake spots me: he's just appeared, to the south.

>w
Upper Hall
The Great Hall of the Abbey is the biggest room I've seen in my life, running from this end all the way southwest (and it is all the way, I'm never allowed further) to the Great Doors and the Yard outside. If I crane my neck I can see the dark square of the floorboards of my room - the ladder is on one side, to the west. Lights move in and out overhead, from the candles moving on their Holy Tracks. Strong smells float through an archway to the east.

From their niches, the Three Major Saints are watching sternly, keen that I should get out of the Cathedral and talk to the Archbishop as quickly as possible.

Looking east, I can see Drake. He's coming this way!

* * *

>w
Upper Hall
The Great Hall of the Abbey is the biggest room I've seen in my life, running from this end all the way southwest (and it is all the way, I'm never allowed further) to the Great Doors and the Yard outside. If I crane my neck I can see the dark square of the floorboards of my room - the ladder is on one side, to the west. Lights move in and out overhead, from the candles moving on their Holy Tracks. Strong smells float through an archway to the east.

From their niches, the Three Major Saints are watching sternly, keen that I should get out of the Cathedral and talk to the Archbishop as quickly as possible.

* * *

>w
Library
The Abbey's library is small compared to the one in the Cathedral. There's nothing on the shelves but the key texts: the Principia, the Mechanistica and the Determininium. Only Brother Horloge, the Abbey's Primary Reader ever seems to use them - he's here at the moment, studying at his desk by the poor light coming through the stained glass windows. By his elbow is a fat bunch of keys. On his shoulder is his mechanical owl, wings folded.

An archway leads east back into the hall. From the southwest comes the clatter of Writing hammers and the sharp smell of burnt ink.

Horloge looks up as I enter. "Ah, young - young Whotsit!" he bellows, pointing a fat finger in my general direction, though through his thick multi-lensed spectacles I don't think he can quite see where I am. "Look here!" he demands. "Young Whotsit-whoever-you-are! I need some - some of that, you know. Some of that whotsit. A good… of whotsit? Uh-huh? Good? Good." He smiles, then looks back down to his studies, muttering.

Horloge's finger shakes terribly as he traces the Holy Lines across the sheet.

>e
Central Hall
I'm standing in the very centre of the Abbey's Great Hall. It's impossible not to crane my neck here, to gaze up at the ceiling held aloft by buttresses like gigantic oak trees. To think, people built this in the days before proper pulley-transmissions! It must have taken weeks! The hall continues northeast into shadow, and southwest, towards the sunlight, the Yard and above all, the Archbishop.

The vast empty space is filled by the muttering and echo of Holy Mechanisms, and the hiss of the candles as they sweep around their Tracks, providing a little light everywhere but rarely ever enough. I can just make out archways both east and west.

I've got a moment before Drake spots me: he's just appeared, to the northeast.

>e
West Refectory
I spend some of my time here, eating at one of the two long tables. I spend even more serving the monks. Each of them has their own seat, marked by a little brass hourglass, and if the twenty or so I can see here weren't enough (which they aren't), there's more to the east, where the Refectory continues. Back west is the archway to the Great Hall.

On the table is a single empty teacup, left over from breakfast.

>get cup
I pick up the empty cup from its place beside by Brother Horloge's hourglass.

>w
Central Hall
I'm standing in the very centre of the Abbey's Great Hall. It's impossible not to crane my neck here, to gaze up at the ceiling held aloft by buttresses like gigantic oak trees. To think, people built this in the days before proper pulley-transmissions! It must have taken weeks! The hall continues northeast into shadow, and southwest, towards the sunlight, the Yard and above all, the Archbishop.

The vast empty space is filled by the muttering and echo of Holy Mechanisms, and the hiss of the candles as they sweep around their Tracks, providing a little light everywhere but rarely ever enough. I can just make out archways both east and west.

Distantly - but not distantly enough - I can hear the clock and clatter of Drake's boots. The sound's coming from the west.

>ne
Upper Hall
The Great Hall of the Abbey is the biggest room I've seen in my life, running from this end all the way southwest (and it is all the way, I'm never allowed further) to the Great Doors and the Yard outside. If I crane my neck I can see the dark square of the floorboards of my room - the ladder is on one side, to the west. Lights move in and out overhead, from the candles moving on their Holy Tracks. Strong smells float through an archway to the east.

From their niches, the Three Major Saints are watching sternly, keen that I should get out of the Cathedral and talk to the Archbishop as quickly as possible.

>e
Kitchen
If there was ever a proof of the perfection of Clockwork over Nature, it's that the dirtiest and most hectic room in the whole Abbey is its Kitchen. Shelves, walls and floor are covered by machines belching, slicing, steaming, chopping, stirring, boiling, broiling, frying, pureeing … the list goes on. The noise, smell and heat is almost overpowering, and the Cook, who controls this madhouse, can only stand it because he's stone deaf.

In one corner is the only machine I'm allowed to use: the Tea Maker. There's a jar of tea leaf beside it. 

I can escape back into the cool of the Hall to the west. South, through a broad arch, is the Refectory.

>get leaf
I can't see any such thing.

>get leaves
(the tea leaves)
I scoop up a handful of tea leaves.

The cook bustles past me, to thump the grater.

Drake's clattering boots are audible to the south.

>w
Upper Hall
The Great Hall of the Abbey is the biggest room I've seen in my life, running from this end all the way southwest (and it is all the way, I'm never allowed further) to the Great Doors and the Yard outside. If I crane my neck I can see the dark square of the floorboards of my room - the ladder is on one side, to the west. Lights move in and out overhead, from the candles moving on their Holy Tracks. Strong smells float through an archway to the east.

From their niches, the Three Major Saints are watching sternly, keen that I should get out of the Cathedral and talk to the Archbishop as quickly as possible.

Drake's on patrol, and I can hear him heading this way, from the east.

* * *

>z
Time passes.

>e
Just in time, I see Drake's there. I hang back, to let him move on.

* * *

>e
Kitchen
If there was ever a proof of the perfection of Clockwork over Nature, it's that the dirtiest and most hectic room in the whole Abbey is its Kitchen. Shelves, walls and floor are covered by machines belching, slicing, steaming, chopping, stirring, boiling, broiling, frying, pureeing … the list goes on. The noise, smell and heat is almost overpowering, and the Cook, who controls this madhouse, can only stand it because he's stone deaf.

In one corner is the only machine I'm allowed to use: the Tea Maker. There's a jar of tea leaf beside it. 

I can escape back into the cool of the Hall to the west. South, through a broad arch, is the Refectory.

The cook pushes past me, to tighten the broiler.

>fill basket
That's not a verb I recognize.

>put leaves in basket
(the handful of tea leaves in the basket)
The basket's now filled with tea leaves.

>inv
I am carrying:
  a teacup
  my lucky clock key (being worn)
  a rag
  a tumbler

>x basket
A fine-mesh wire basket positioned near the front of the machine, right over the circular bracket. It's filled with fresh tea leaves.

Drake's clattering boots are audible to the south.

>turn spigot
Nothing obvious happens.

Looking south, I can see Drake. He's coming this way!

>w
Upper Hall
The Great Hall of the Abbey is the biggest room I've seen in my life, running from this end all the way southwest (and it is all the way, I'm never allowed further) to the Great Doors and the Yard outside. If I crane my neck I can see the dark square of the floorboards of my room - the ladder is on one side, to the west. Lights move in and out overhead, from the candles moving on their Holy Tracks. Strong smells float through an archway to the east.

From their niches, the Three Major Saints are watching sternly, keen that I should get out of the Cathedral and talk to the Archbishop as quickly as possible.

Drake's just off to the east, and he's coming this way!

* * *

>e
Kitchen
If there was ever a proof of the perfection of Clockwork over Nature, it's that the dirtiest and most hectic room in the whole Abbey is its Kitchen. Shelves, walls and floor are covered by machines belching, slicing, steaming, chopping, stirring, boiling, broiling, frying, pureeing … the list goes on. The noise, smell and heat is almost overpowering, and the Cook, who controls this madhouse, can only stand it because he's stone deaf.

In one corner is the only machine I'm allowed to use: the Tea Maker. There's a jar of tea leaf beside it. 

I can escape back into the cool of the Hall to the west. South, through a broad arch, is the Refectory.

>turn on spigor
I can't see any such thing.

>turn on spigot
The spigot releases a thin dribble of water into the kettle. Across the room, the clouds coming from the steamer suddenly thin out and the Cook pauses to give me the most evil of evil stars. I turn the spigot closed again.

The cook bustles past me, to thump the masher.

>open spigot
There's plenty of water in the kettle, thanks.

That's already on.

>fill kettle
That's not a verb I recognize.

>turn off spigor
I can't see any such thing.

>turn off spigot
I switch the spigot off.

Drake's footsteps echo in from the south.

* * *

>take string
That seems to be a part of my lucky clock key.

>take me
You are always self-possessed.

* * *

>take bob
I don't suppose Bob would care for that.

>get string
That seems to be a part of my lucky clock key.

* * *

>take carrot
That seems to belong to Bob.

* * *

>take diamond
You can't see any such thing.

>rules
Rules tracing now switched on. Type "rules off" to switch it off again, or "rules all" to include even rules which do not apply.

>take diamond
You can't see any such thing.

>take diamond all
You can't see any such thing.

>take diamond
You can't see any such thing.

>rules all
Rules tracing now switched to "all". Type "rules off" to switch it off again.

>take diamond
You can't see any such thing.

>rules off
[Rule "standard set taking variables rule" does not apply.]
[Rule "standard set going variables rule" does not apply.]
[Rule "determine visibility ceiling rule" does not apply.]
[Rule "Setting action variables for exiting" does not apply.]
Rules tracing now switched off. Type "rules" to switch it on again.

* * *

>enter box
You get into the box.

>get box
You'd have to get out of the box first.

>rules
Rules tracing now switched on. Type "rules off" to switch it off again, or "rules all" to include even rules which do not apply.

>get box
[Rule "standard set taking variables rule" applies.]
    [Rule "avoid unnecessary implicit taking rule" applies.]
    [Rule "can't take other people rule" applies.]
    [Rule "can't take component parts rule" applies.]
    [Rule "can't take people's possessions rule" applies.]
    [Rule "can't take items out of play rule" applies.]
    [Rule "can't take what you're inside rule" applies.]
You'd have to get out of the box first.

* * *

>polish
What do you want to polish?

* * *

>drop rag
Dropped.

>polish bob
You must supply a second noun.

>get rag
Taken.

>inv
I am carrying:
  a rag
  my lucky clock key (being worn)
  a tumbler

>get on box
You get onto the box.

>get box
I'd have to get off the box first.

That's fixed in place.

>d
You'll have to get off the box first.

>stand up
You get off the box.

Abbot's Quarters
If I thought Abbots lived in luxury, then I was dead wrong. Even my attic's cosier than this. The Abbot's got no furniture at all, except a desk and a cot, and no decoration except for a bust of St. Newton. None of the axle-mounted bevelled mobiles I was expecting. There's barely even any sunlight: one thin window to catch the sun-rise, opposite the door to the hallway back west.

St. Newton is staring at the Abbot's unpolished Grandfather clock with a severe frown.

You can also see Bob and a box here.

>undo
Abbot's Quarters
[Previous turn undone.]

>get down
You must name something more substantial.

>get off
You get off the box.

Abbot's Quarters
If I thought Abbots lived in luxury, then I was dead wrong. Even my attic's cosier than this. The Abbot's got no furniture at all, except a desk and a cot, and no decoration except for a bust of St. Newton. None of the axle-mounted bevelled mobiles I was expecting. There's barely even any sunlight: one thin window to catch the sun-rise, opposite the door to the hallway back west.

St. Newton is staring at the Abbot's unpolished Grandfather clock with a severe frown.

You can also see Bob and a box here.

* * *

>get on box
You get onto the box.

>get bo
You can't see any such thing.

>get box
I'd have to get off the box first.

>get down
You must name something more substantial.

* * *

>get off
You get off the box.

Abbot's Quarters
If I thought Abbots lived in luxury, then I was dead wrong. Even my attic's cosier than this. The Abbot's got no furniture at all, except a desk and a cot, and no decoration except for a bust of St. Newton. None of the axle-mounted bevelled mobiles I was expecting. There's barely even any sunlight: one thin window to catch the sun-rise, opposite the door to the hallway back west.

St. Newton is staring at the Abbot's unpolished Grandfather clock with a severe frown.

You can also see Bob and a box here.

>take box
That's fixed in place.

* * *

>get box
Taken.

>drop box
Dropped.

>x box
You see nothing special about the box.

* * *

>l
Abbot's Quarters
If I thought Abbots lived in luxury, then I was dead wrong. Even my attic's cosier than this. The Abbot's got no furniture at all, except a desk and a cot, and no decoration except for a bust of St. Newton. None of the axle-mounted bevelled mobiles I was expecting. There's barely even any sunlight: one thin window to catch the sun-rise, opposite the door to the hallway back west.

St. Newton is staring at the Abbot's unpolished Grandfather clock with a severe frown.

>l
Abbot's Quarters
If I thought Abbots lived in luxury, then I was dead wrong. Even my attic's cosier than this. The Abbot's got no furniture at all, except a desk and a cot, and no decoration except for a bust of St. Newton. None of the axle-mounted bevelled mobiles I was expecting. There's barely even any sunlight: one thin window to catch the sun-rise, opposite the door to the hallway back west.

St. Newton is staring at the Abbot's unpolished Grandfather clock with a severe frown.

"And don't come out till that clock's shining!" shouts Drake from the hall.

"Yeah," Calvin says. "It's got to look as good as if we did it!"

"Idiot," Drake mutters. "Come on."

Their voices disappear down the hall.

* * *

>w
I'm not staying here. I walk straight out again… but Drake's waiting to push me back.

"Polish the clock, loose-screw!" he clangs. "And don't come out till it's shining!"

"Yeah," Calvin says. "It's got to look as good as if we did it!"

"Idiot," Drake mutters. "Come on."

Their voices disappear down the hall.

>z
Time passes.

The grandfather clock ticks off a minute with a stately thunk. Quickly, I make the sign of the winding gear.

>zz
I didn't understand that sentence.

>z
Time passes.

* * *

>w
I'm not staying here. I walk straight out again… but Drake's waiting to push me back.

"Polish the clock, loose-screw!" he clangs. "And don't come out till it's shining!"

"Yeah," Calvin says. "It's got to look as good as if we did it!"

"Idiot," Drake mutters. "Come on."

Their voices disappear down the hall.

>w
Curses to counterweights! It's not on my rota, this clock, so why should I finish off my polish on it? I head for the doorway - then freeze. Voices, coming down the hall. It's the Abbot himself, coming this way!

>undo
Abbot's Quarters
[Previous turn undone.]

>rub rag
The grandfather clock ticks off a minute with a stately thunk. Quickly, I make the sign of the winding gear.

>w
Curses to counterweights! It's not on my rota, this clock, so why should I finish off my polish on it? I head for the doorway - then freeze. Voices, coming down the hall. It's the Abbot himself, coming this way!

>l
Abbot's Quarters
If I thought Abbots lived in luxury, then I was dead wrong. Even my attic's cosier than this. The Abbot's got no furniture at all, except a desk and a cot, and no decoration except for a bust of St. Newton. None of the axle-mounted bevelled mobiles I was expecting. There's barely even any sunlight: one thin window to catch the sun-rise, opposite the door to the hallway back west.

St. Newton is staring at the Abbot's unpolished Grandfather clock with a severe frown.

>l
Abbot's Quarters
If I thought Abbots lived in luxury, then I was dead wrong. Even my attic's cosier than this. The Abbot's got no furniture at all, except a desk and a cot, and no decoration except for a bust of St. Newton. None of the axle-mounted bevelled mobiles I was expecting. There's barely even any sunlight: one thin window to catch the sun-rise, opposite the door to the hallway back west.

St. Newton is staring at the Abbot's unpolished Grandfather clock with a severe frown.

>z
Time passes.

* * *

>w
Curses to counterweights! It's not on my rota, this clock, so why should I finish off my polish on it? I head for the doorway - then freeze. Voices, coming down the hall. It's the Abbot himself, coming this way!

>enter clock
"We'll talk in here," I hear the Abbot saying, from right outside the door. "More private. More quiet. Much better." The old man steps inside the room, followed by a tall figure in grey. In the last tick before his old eyes can see me, I dive inside the gigantic clock case and pull closed the door.

Inside Clock Case
As the phrase goes, I'm stuck between a rack and a gear-trace; except here I'm in the narrow gap between the clock case door and the heavy swinging penduluum behind. And if that hit me, and disrupted the holy timings… well, there's no way they wouldn't notice when the clock-hands stopped moving, let's just say.

A little light shines in through the keyhole, which is almost covered by the Abbot's spare robe.

Oh, no… That click outside was the sound of the Abbot closing the door. Looks like he - and the grey figure I glimpsed with him - are going to be here for a while…

>x abbout
I can't see any such thing.

>x abbot
I can't see any such thing.

>x figure
I can't see any such thing.

>z
Time passes.

>x figure
I can't see any such thing.

* * *

>z
Time passes.

>scenes
Scene 'Entire Game' playing (for 6 mins now)
Scene 'Introduction' playing (for 6 mins now)
(Scene monitoring now switched on. Type "scenes off" to switch it off again.)

>l
Inside Clock Case
As the phrase goes, I'm stuck between a rack and a gear-trace; except here I'm in the narrow gap between the clock case door and the heavy swinging penduluum behind. And if that hit me, and disrupted the holy timings… well, there's no way they wouldn't notice when the clock-hands stopped moving, let's just say.

A little light shines in through the keyhole, which is almost covered by the Abbot's spare robe.

* * *

>out
You've got a spring missing if you think I can slip out, unnoticed, or come up with a decent excuse as to why I've been hiding in the Abbot's grandfather. No, I'm staying put and hoping nothing happens to make the old man need to change his clothes.

"I told you now didn't I tell you?" old Abbot Gubbler is saying, plaintively. "Here? Why here? You shouldn't have come here."

The Figure says something in reply. I can only hear two words, but they're enough to stop my heart. "Failure," and "Consequences."

>put tumbler on door
Oh… well, then. I tip out the last of the polish onto the floor of the clock. At least that part will shine.

I put the glass tumbler carefully against the door, then lean down to press my ear against it. Fantastic! I can hear much more clearly now!

"But these things, these things are not always tick-tock, they never are," the old man replies. His voice is quivering, quite different from the steady drone he has when intoning in Chapel. "The - item you asked about - it's in the Vaults, you see? The Vaults. Even if I could get in, I …"

"Your excuses we find disappointing. Very disappointing. More of this and, Abbot, we may need to unslip your gears completely."

>open door
You've got a spring missing if you think I can slip out, unnoticed, or come up with a decent excuse as to why I've been hiding in the Abbot's grandfather. No, I'm staying put and hoping nothing happens to make the old man need to change his clothes.

The Abbot is spluttering and choking. You've seen him like this only once, when as a young initiate you dropped and smashed an altimeter right before the Archbishop was due to visit.

The Figure continues. "Clearly you're too old to steal the item for us. We have a better mechanism for obtaining it. But you must provide us with the opportunity. Is that understood?"

The Abbot nods violently, shaking out agreement the way I might beat dirt from a duster. "My money?" he asks.

>push door
You've got a spring missing if you think I can slip out, unnoticed, or come up with a decent excuse as to why I've been hiding in the Abbot's grandfather. No, I'm staying put and hoping nothing happens to make the old man need to change his clothes.

There's the clink, of a pouch of golden minutes. A heavy pouch. The Figure, paying the Abbot…? Then suddenly, there's a third voice. "Sorry, Father, to interrupt, but you said…"

It's a monk of the Abbey. "Get out!" the Abbot screeches. His bearing's lost its oil, it seems. "Get out, get out!"

"But Father," the monk continues, "it's time, you know. You told me to tell you when it was time."

"Oh! Of course of course," he mumbles. "I'll… We'll continue this discussion later, then," he says, to the Figure.

"We certainly will," the Figure replies.

The Abbot leaves, and that leaves me alone, inside this clock, with the stranger outside. He's coming nearer… I can hear his fingers on the door of the case! I must have nudged the penduluum, he must have seen the clock-hands quiver… but then, there's the swish of his cloak as he moves away, and the click as the door closes. Phew.

>close door
That's already closed.

>out
I spill gratefully out of the clock, gasping for breath as though I've been underwater. I've just been holding it in, of course. As what I've heard - well, I probably shouldn't have, and the quicker I can get out of here, the better.

Abbot's Quarters
If I thought Abbots lived in luxury, then I was dead wrong. Even my attic's cosier than this. The Abbot's got no furniture at all, except a desk and a cot, and no decoration except for a bust of St. Newton. None of the axle-mounted bevelled mobiles I was expecting. There's barely even any sunlight: one thin window to catch the sun-rise, opposite the door to the hallway back west.

St. Newton is staring at the Abbot's unpolished Grandfather clock with a severe frown.

>w
I can't, since the Abbot's Door is in the way.

* * *

>z
Time passes.

"I told you now didn't I tell you?" old Abbot Gubbler is saying, plaintively. "Here? Why here? You shouldn't have come here."

The Figure says something in reply. I can only hear two words, but they're enough to stop my heart. "Failure," and "Consequences."

I beg your pardon?

>z
Time passes.

"But these things, these things are not always tick-tock, they never are," the old man replies. His voice is quivering, quite different from the steady drone he has when intoning in Chapel. "The - item you asked about - it's in the Vaults, you see? The Vaults. Even if I could get in, I …"

The Figure is too far from the keyhole and speaks too quietly for me to hear clearly. "Disappointing," he says; and then "unslip your gears."

>z
Time passes.

The Abbot is spluttering and choking. You've seen him like this only once, when as a young initiate you dropped and smashed an altimeter right before the Archbishop was due to visit.

The Figure's quiet voice continues. I can make out; "too old to steal", "a better mechanism", "the opportunity."

The Abbot nods violently, shaking out agreement the way I might beat dirt from a duster. "My money?" he asks.

>z
Time passes.

There's the clink, of a pouch of golden minutes. A heavy pouch. The Figure, paying the Abbot…? Then suddenly, there's a third voice. "Sorry, Father, to interrupt, but you said…"

It's a monk of the Abbey. "Get out!" the Abbot screeches. His bearing's lost its oil, it seems. "Get out, get out!"

"But Father," the monk continues, "it's time, you know. You told me to tell you when it was time."

"Oh! Of course of course," he mumbles. "I'll… We'll continue this discussion later, then," he says, to the Figure.

The Figure intones something in reply.

The Abbot leaves, and that leaves me alone, inside this clock, with the stranger outside. He's coming nearer… I can hear his fingers on the door of the case! I must have nudged the penduluum, he must have seen the clock-hands quiver… but then, there's the swish of his cloak as he moves away, and the click as the door closes. Phew.

>out
I spill gratefully out of the clock, gasping for breath as though I've been underwater. I've just been holding it in, of course. As what I've heard - well, I probably shouldn't have, and the quicker I can get out of here, the better.

Abbot's Quarters
If I thought Abbots lived in luxury, then I was dead wrong. Even my attic's cosier than this. The Abbot's got no furniture at all, except a desk and a cot, and no decoration except for a bust of St. Newton. None of the axle-mounted bevelled mobiles I was expecting. There's barely even any sunlight: one thin window to catch the sun-rise, opposite the door to the hallway back west.

St. Newton is staring at the Abbot's unpolished Grandfather clock with a severe frown.

* * *

I beg your pardon?

>d
I scramble quickly down the ladder.

Rickety Stair
I'm in one corner of the Great Hall, just by the foot of the ladder up to my room. There's a note attached to it, asking Amble the caretaker not to put it back in the shed just yet.

* * *

>x statue
The Three Major Saints examine me right back, their faces shining with Holy Precision. St Breguet, the Maker; St Newton, the Thinker; and St Babbage, the Calculatrometrist. They're only statues, of course, but they're still quite creepy here in the half-light of the moving candles.

>x statue of st breguet
I only understood you as far as wanting to examine the statues.

>x statue st breguet
I only understood you as far as wanting to examine the statues.

>x statue of breguet
I only understood you as far as wanting to examine the statues.

>x breguet statue
The Three Major Saints examine me right back, their faces shining with Holy Precision. St Breguet, the Maker; St Newton, the Thinker; and St Babbage, the Calculatrometrist. They're only statues, of course, but they're still quite creepy here in the half-light of the moving candles.

* * *

>z
Time passes.

"I told you now didn't I tell you?" old Abbot Gubbler is saying, plaintively. "Here? Why here? You shouldn't have come here."

The Figure says something in reply. I can only hear two words, but they're enough to stop my heart. "Failure," and "Consequences."

>z
Time passes.

"But these things, these things are not always tick-tock, they never are," the old man replies. His voice is quivering, quite different from the steady drone he has when intoning in Chapel. "The - item you asked about - it's in the Vaults, you see? The Vaults. Even if I could get in, I …"

The Figure is too far from the keyhole and speaks too quietly for me to hear clearly. "Disappointing," he says; and then "unslip your gears."

* * *

>x newton
The Three Major Saints examine me right back, their faces shining with Holy Precision. St Breguet, the Maker; St Newton, the Thinker; and St Babbage, the Calculatrometrist. They're only statues, of course, but they're still quite creepy here in the half-light of the moving candles.

>x statue of st newton
The Three Major Saints examine me right back, their faces shining with Holy Precision. St Breguet, the Maker; St Newton, the Thinker; and St Babbage, the Calculatrometrist. They're only statues, of course, but they're still quite creepy here in the half-light of the moving candles.

>x st
The Three Major Saints examine me right back, their faces shining with Holy Precision. St Breguet, the Maker; St Newton, the Thinker; and St Babbage, the Calculatrometrist. They're only statues, of course, but they're still quite creepy here in the half-light of the moving candles.

>x st newton
The Three Major Saints examine me right back, their faces shining with Holy Precision. St Breguet, the Maker; St Newton, the Thinker; and St Babbage, the Calculatrometrist. They're only statues, of course, but they're still quite creepy here in the half-light of the moving candles.

Distantly - but not distantly enough - I can hear the clock and clatter of Drake's boots. The sound's coming from the east.

>x saint newton
The Three Major Saints examine me right back, their faces shining with Holy Precision. St Breguet, the Maker; St Newton, the Thinker; and St Babbage, the Calculatrometrist. They're only statues, of course, but they're still quite creepy here in the half-light of the moving candles.

Drake's just off to the east, and he's coming this way!

>x newton
The Three Major Saints examine me right back, their faces shining with Holy Precision. St Breguet, the Maker; St Newton, the Thinker; and St Babbage, the Calculatrometrist. They're only statues, of course, but they're still quite creepy here in the half-light of the moving candles.

"Wren!" Drake exclaims. He wallops me on the arm. "I thought I told you to stay in your room?" He doesn't wait for an excuse before I'm dragged off to the ladder. Then he waits - and wallops me - until I give in and climb all the way back up.

Attic Room
This isn't really an attic. It isn't really a room either. It's a couple of floorboards laid across some roof rafters right in the ceiling of the Abbey. There's enough floor-space for a cot and a laundry crate, but I have to be careful not to roll out of bed, because if I do, the thick cobwebs all around aren't going to stop me from falling….

A little hole in the ceiling provides some sunlight: and when it rains, it means I can wash my hair, too. It's right above the rickety ladder down to the ground (and that means the ladder is starting to rot and bend).

That was careless, getting caught. But I can still make it to the Cathedral. I'll just have to be more cunning this time. Remember, Wren, it's easy: the whole world runs on clockwork. Just a matter of staying ahead of the biting teeth.

>x newton breguet
I can't see any such thing.

>x st
On tiptoes, I can see right across the city of St Philip. It's a maze of rooftops like a tangle of thorn bushes. If people could only see this view, then they might not be so strict about Precision and Good Order… Or maybe they would, because looming over all the houses are the great spires of the Cathedral of Time, its great clock keeping time for the whole city.

>x saint babbage
I can't see any such thing.

>w
Rickety Stair
I'm in one corner of the Great Hall, just by the foot of the ladder up to my room. There's a note attached to it, asking Amble the caretaker not to put it back in the shed just yet.

* * *

>x three major saints
The Three Major Saints examine me right back, their faces shining with Holy Precision. St Breguet, the Maker; St Newton, the Thinker; and St Babbage, the Calculatrometrist. They're only statues, of course, but they're still quite creepy here in the half-light of the moving candles.

>x statues of three major saints
The Three Major Saints examine me right back, their faces shining with Holy Precision. St Breguet, the Maker; St Newton, the Thinker; and St Babbage, the Calculatrometrist. They're only statues, of course, but they're still quite creepy here in the half-light of the moving candles.

>x statues of the three major saints
The Three Major Saints examine me right back, their faces shining with Holy Precision. St Breguet, the Maker; St Newton, the Thinker; and St Babbage, the Calculatrometrist. They're only statues, of course, but they're still quite creepy here in the half-light of the moving candles.

>x statues of major three major saints
The Three Major Saints examine me right back, their faces shining with Holy Precision. St Breguet, the Maker; St Newton, the Thinker; and St Babbage, the Calculatrometrist. They're only statues, of course, but they're still quite creepy here in the half-light of the moving candles.

* * *

>x saint babbage
I can't see any such thing.

>d
I scramble quickly down the ladder.

Rickety Stair
I'm in one corner of the Great Hall, just by the foot of the ladder up to my room. There's a note attached to it, asking Amble the caretaker not to put it back in the shed just yet.

* * *

>x saint babbage
The Three Major Saints examine me right back, their faces shining with Holy Precision. St Breguet, the Maker; St Newton, the Thinker; and St Babbage, the Calculatrometrist. They're only statues, of course, but they're still quite creepy here in the half-light of the moving candles.

>x st newton
The Three Major Saints examine me right back, their faces shining with Holy Precision. St Breguet, the Maker; St Newton, the Thinker; and St Babbage, the Calculatrometrist. They're only statues, of course, but they're still quite creepy here in the half-light of the moving candles.

>x saint newton
The Three Major Saints examine me right back, their faces shining with Holy Precision. St Breguet, the Maker; St Newton, the Thinker; and St Babbage, the Calculatrometrist. They're only statues, of course, but they're still quite creepy here in the half-light of the moving candles.

>x saint breguet
The Three Major Saints examine me right back, their faces shining with Holy Precision. St Breguet, the Maker; St Newton, the Thinker; and St Babbage, the Calculatrometrist. They're only statues, of course, but they're still quite creepy here in the half-light of the moving candles.

Drake's footsteps echo in from the east.

>x breguet
The Three Major Saints examine me right back, their faces shining with Holy Precision. St Breguet, the Maker; St Newton, the Thinker; and St Babbage, the Calculatrometrist. They're only statues, of course, but they're still quite creepy here in the half-light of the moving candles.

Drake's just off to the east, and he's coming this way!

>x isaac
The Three Major Saints examine me right back, their faces shining with Holy Precision. St Breguet, the Maker; St Newton, the Thinker; and St Babbage, the Calculatrometrist. They're only statues, of course, but they're still quite creepy here in the half-light of the moving candles.

Drake looks like he's swallowed a bee. Not only have I disobeyed him, but I've done it twice. "I'm going to have your skin," he hisses into in my ear. "I'm going to use it as a cloak comes winter. Understand?" With that he drags me back off to my attic. This time, I can barely climb the stairs.

Attic Room
This isn't really an attic. It isn't really a room either. It's a couple of floorboards laid across some roof rafters right in the ceiling of the Abbey. There's enough floor-space for a cot and a laundry crate, but I have to be careful not to roll out of bed, because if I do, the thick cobwebs all around aren't going to stop me from falling….

A little hole in the ceiling provides some sunlight: and when it rains, it means I can wash my hair, too. It's right above the rickety ladder down to the ground (and that means the ladder is starting to rot and bend).

A quick pause for breath and… right then. I'm ready. I'm going to get out of the Abbey somehow, and warn the Archbishop. And I won't give up till I've got there!

>x statues of st isaac
I can't see any such thing.

>w
I can't go that way.

>z
Time passes.

>e
I can't go that way.

>x st isaac the thinker
I only understood you as far as wanting to examine the distant city of St Philip.

>d
I scramble quickly down the ladder.

Rickety Stair
I'm in one corner of the Great Hall, just by the foot of the ladder up to my room. There's a note attached to it, asking Amble the caretaker not to put it back in the shed just yet.

* * *

>x statue of st isaac newton the thinker
The Three Major Saints examine me right back, their faces shining with Holy Precision. St Breguet, the Maker; St Newton, the Thinker; and St Babbage, the Calculatrometrist. They're only statues, of course, but they're still quite creepy here in the half-light of the moving candles.

>sw
Center Hall
I'm standing in the very centre of the Abbey's Great Hall. It's impossible not to crane my neck here, to gaze up at the ceiling held aloft by buttresses like gigantic oak trees. To think, people built this in the days before proper pulley-transmissions! It must have taken weeks! The hall continues northeast into shadow, and southwest, towards the sunlight, the Yard and above all, the Archbishop.

The vast empty space is filled by the muttering and echo of Holy Mechanisms, and the hiss of the candles as they sweep around their Tracks, providing a little light everywhere but rarely ever enough. I can just make out archways both east and west.

* * *

>sw
Central Hall
I'm standing in the very centre of the Abbey's Great Hall. It's impossible not to crane my neck here, to gaze up at the ceiling held aloft by buttresses like gigantic oak trees. To think, people built this in the days before proper pulley-transmissions! It must have taken weeks! The hall continues northeast into shadow, and southwest, towards the sunlight, the Yard and above all, the Archbishop.

The vast empty space is filled by the muttering and echo of Holy Mechanisms, and the hiss of the candles as they sweep around their Tracks, providing a little light everywhere but rarely ever enough. I can just make out archways both east and west.

I've got a moment before Drake spots me: he's just appeared, to the west.

>ne
Upper Hall
The Great Hall of the Abbey is the biggest room I've seen in my life, running from this end all the way southwest (and it is all the way, I'm never allowed further) to the Great Doors and the Yard outside. If I crane my neck I can see the dark square of the floorboards of my room - the ladder is on one side, to the west. Lights move in and out overhead, from the candles moving on their Holy Tracks. Strong smells float through an archway to the east.

From their niches, the Three Major Saints are watching sternly, keen that I should get out of the Cathedral and talk to the Archbishop as quickly as possible.

>sw
Just in time, I see Drake's there. I hang back, to let him move on.

* * *

>w
Library
The Abbey's library is small compared to the one in the Cathedral. There's nothing on the shelves but the key texts: the Principia, the Mechanistica and the Determininium. Only Brother Horloge, the Abbey's Primary Reader ever seems to use them - he's here at the moment, studying at his desk by the poor light coming through the stained glass windows. By his elbow is a fat bunch of keys. On his shoulder is his mechanical owl, wings folded.

An archway leads east back into the hall. From the southwest comes the clatter of Writing hammers and the sharp smell of burnt ink.

>z
Time passes.

>z
Time passes.

Horloge's finger shakes terribly as he traces the Holy Lines across the sheet.

Drake's on patrol, and I can hear him heading this way, from the southwest.

>e
Central Hall
I'm standing in the very centre of the Abbey's Great Hall. It's impossible not to crane my neck here, to gaze up at the ceiling held aloft by buttresses like gigantic oak trees. To think, people built this in the days before proper pulley-transmissions! It must have taken weeks! The hall continues northeast into shadow, and southwest, towards the sunlight, the Yard and above all, the Archbishop.

The vast empty space is filled by the muttering and echo of Holy Mechanisms, and the hiss of the candles as they sweep around their Tracks, providing a little light everywhere but rarely ever enough. I can just make out archways both east and west.

Drake's clattering boots are audible to the west.

>sw
Lower Hall
Looking northeast, the Great Hall of the Abbey stretches away like the belly of some big beast, its bony roof held up by pillars like swallowed trees. The walls are carelessly lit by candles moving through Sacred Tracks suspended in the air. I can just make out the Corridor of Contemplation to the east, and the wider archway to the Scriptorium to the west.

But more importantly, the great Entry - and exit - of the Abbey is to the southwest. And if I'm going to get out of here and talk to the Archbishop that's the only way to go.

But maybe you're starting to see what kind of luck I have. Right there, in the Entry, is Calvin, working on a clock.

>w
Scriptorium
The Scriptorium is where the Copying takes place, though it's hard to believe that Copying once meant a team of monks working with carved rubber stamps. It's all done by mechanisms now, of course, like everything else except my chores. There's the massive Gutenberg press on the west wall, and everywhere else is Brother Reloh's Duplicator. Twenty-three Typewriters, all clattering away as though operated by ghosts, all connected by a single Carriage Arm that curves the length of the wall. To leave the room east or northeast I'll have to duck under.

Reloh works on one of the keyboards of the Duplicator, typing furiously. The hammering and punching is almost overwhelming.

The Gutenberg seems to be in the midst of a repair. The Cabinet of Relics next to it is open.

>ne
Library
The Abbey's library is small compared to the one in the Cathedral. There's nothing on the shelves but the key texts: the Principia, the Mechanistica and the Determininium. Only Brother Horloge, the Abbey's Primary Reader ever seems to use them - he's here at the moment, studying at his desk by the poor light coming through the stained glass windows. By his elbow is a fat bunch of keys. On his shoulder is his mechanical owl, wings folded.

An archway leads east back into the hall. From the southwest comes the clatter of Writing hammers and the sharp smell of burnt ink.

>z
Time passes.

>z
Time passes.

Drake's footsteps echo in from the southwest.

>e
Central Hall
I'm standing in the very centre of the Abbey's Great Hall. It's impossible not to crane my neck here, to gaze up at the ceiling held aloft by buttresses like gigantic oak trees. To think, people built this in the days before proper pulley-transmissions! It must have taken weeks! The hall continues northeast into shadow, and southwest, towards the sunlight, the Yard and above all, the Archbishop.

The vast empty space is filled by the muttering and echo of Holy Mechanisms, and the hiss of the candles as they sweep around their Tracks, providing a little light everywhere but rarely ever enough. I can just make out archways both east and west.

Drake's clattering boots are audible to the west.

* * *

>z
Time passes.

>z
Time passes.

Horloge reaches up to pet his owl. The bird is motionless.

>z
Time passes.

The sun shifts a little, and the Brother nudges the table to follow the pool of light.

>z
Time passes.

Horloge reaches up to pet his owl. The bird is motionless.

>z
Time passes.

Drake's footsteps echo in from the southwest.

* * *

>z
Time passes.

>z
Time passes.

The sun shifts a little, and the Brother nudges the table to follow the pool of light.

>z
Time passes.

>e
Just in time, I see Drake's there. I hang back, to let him move on.

Drake's on patrol, and I can hear him heading this way, from the southwest.

>e
Central Hall
I'm standing in the very centre of the Abbey's Great Hall. It's impossible not to crane my neck here, to gaze up at the ceiling held aloft by buttresses like gigantic oak trees. To think, people built this in the days before proper pulley-transmissions! It must have taken weeks! The hall continues northeast into shadow, and southwest, towards the sunlight, the Yard and above all, the Archbishop.

The vast empty space is filled by the muttering and echo of Holy Mechanisms, and the hiss of the candles as they sweep around their Tracks, providing a little light everywhere but rarely ever enough. I can just make out archways both east and west.

Drake's footsteps echo in from the west.

>sw
Lower Hall
Looking northeast, the Great Hall of the Abbey stretches away like the belly of some big beast, its bony roof held up by pillars like swallowed trees. The walls are carelessly lit by candles moving through Sacred Tracks suspended in the air. I can just make out the Corridor of Contemplation to the east, and the wider archway to the Scriptorium to the west.

But more importantly, the great Entry - and exit - of the Abbey is to the southwest. And if I'm going to get out of here and talk to the Archbishop that's the only way to go.

But maybe you're starting to see what kind of luck I have. Right there, in the Entry, is Calvin, working on a clock.

* * *

>z
Time passes.

>sw
Scriptorium
The Scriptorium is where the Copying takes place, though it's hard to believe that Copying once meant a team of monks working with carved rubber stamps. It's all done by mechanisms now, of course, like everything else except my chores. There's the massive Gutenberg press on the west wall, and everywhere else is Brother Reloh's Duplicator. Twenty-three Typewriters, all clattering away as though operated by ghosts, all connected by a single Carriage Arm that curves the length of the wall. To leave the room east or northeast I'll have to duck under.

Reloh works on one of the keyboards of the Duplicator, typing furiously. The hammering and punching is almost overwhelming.

The Gutenberg seems to be in the midst of a repair. The Cabinet of Relics next to it is open.

>e
Lower Hall
Looking northeast, the Great Hall of the Abbey stretches away like the belly of some big beast, its bony roof held up by pillars like swallowed trees. The walls are carelessly lit by candles moving through Sacred Tracks suspended in the air. I can just make out the Corridor of Contemplation to the east, and the wider archway to the Scriptorium to the west.

But more importantly, the great Entry - and exit - of the Abbey is to the southwest. And if I'm going to get out of here and talk to the Archbishop that's the only way to go.

But maybe you're starting to see what kind of luck I have. Right there, in the Entry, is Calvin, working on a clock.

Drake's just off to the northeast, and he's coming this way!

>ne
Just in time, I see Drake's there. I hang back, to let him move on.

Drake looks like he's swallowed a bee. Not only have I disobeyed him, but I've done it twice. "I'm going to have your skin," he hisses into in my ear. "I'm going to use it as a cloak comes winter. Understand?" With that he drags me back off to my attic. This time, I can barely climb the stairs.

Attic Room
This isn't really an attic. It isn't really a room either. It's a couple of floorboards laid across some roof rafters right in the ceiling of the Abbey. There's enough floor-space for a cot and a laundry crate, but I have to be careful not to roll out of bed, because if I do, the thick cobwebs all around aren't going to stop me from falling….

A little hole in the ceiling provides some sunlight: and when it rains, it means I can wash my hair, too. It's right above the rickety ladder down to the ground (and that means the ladder is starting to rot and bend).

A quick pause for breath and… right then. I'm ready. I'm going to get out of the Abbey somehow, and warn the Archbishop. And I won't give up till I've got there!

* * *

>set tumbler to 3:15
No, I can't set that to anything.

"I told you now didn't I tell you?" old Abbot Gubbler is saying, plaintively. "Here? Why here? You shouldn't have come here."

The Figure says something in reply. I can only hear two words, but they're enough to stop my heart. "Failure," and "Consequences."

>listen with tumbler
Oh… well, then. I tip out the last of the polish onto the floor of the clock. At least that part will shine.

I put the glass tumbler carefully against the door, then lean down to press my ear against it. Fantastic! I can hear much more clearly now!

"But these things, these things are not always tick-tock, they never are," the old man replies. His voice is quivering, quite different from the steady drone he has when intoning in Chapel. "The - item you asked about - it's in the Vaults, you see? The Vaults. Even if I could get in, I …"

"Your excuses we find disappointing. Very disappointing. More of this and, Abbot, we may need to unslip your gears completely."

>z
Time passes.

The Abbot is spluttering and choking. You've seen him like this only once, when as a young initiate you dropped and smashed an altimeter right before the Archbishop was due to visit.

The Figure continues. "Clearly you're too old to steal the item for us. We have a better mechanism for obtaining it. But you must provide us with the opportunity. Is that understood?"

The Abbot nods violently, shaking out agreement the way I might beat dirt from a duster. "My money?" he asks.

* * *

>e
Kitchen
If there was ever a proof of the perfection of Clockwork over Nature, it's that the dirtiest and most hectic room in the whole Abbey is its Kitchen. Shelves, walls and floor are covered by machines belching, slicing, steaming, chopping, stirring, boiling, broiling, frying, pureeing … the list goes on. The noise, smell and heat is almost overpowering, and the Cook, who controls this madhouse, can only stand it because he's stone deaf.

I can escape back into the cool of the Hall to the west. South, through a broad arch, is the Refectory.

>s
East Refectory
The eastern end of the long Refectory is given over in part to the tables lined with brass hourglasses, but in the other half there's nothing but the enormous Refectory Clock. It's an impressive thing, so big because it only needs winding once a year, despite all the gongs, cymbals, tubes and bells that strike when dinner time comes around. Right now, the clock is showing the time at just after quarter past three.

Pungent smells drift in from the kitchen to the north. On the east wall is the small green door to the Abbey's herb garden.

I can see a garden door here.

Distantly - but not distantly enough - I can hear the clock and clatter of Drake's boots. The sound's coming from the west.

>set clock to 3:18
*** Run-time problem P10: Since the Refectory Clock is not allowed the property "adjusted time understood", it is against the rules to try to use it.

*** Run-time problem P10: Since the Refectory Clock is not allowed the property "adjusted time understood", it is against the rules to try to use it.

I turn the clock hands to 
*** Run-time problem P10: Since the Refectory Clock is not allowed the property "adjusted time understood", it is against the rules to try to use it.

twelve o'clock.

Looking west, I can see Drake. He's coming this way!

>undo
East Refectory
[Previous turn undone.]

>set clock to three fifteen
*** Run-time problem P10: Since the Refectory Clock is not allowed the property "adjusted time understood", it is against the rules to try to use it.

*** Run-time problem P10: Since the Refectory Clock is not allowed the property "adjusted time understood", it is against the rules to try to use it.

I turn the clock hands to 
*** Run-time problem P10: Since the Refectory Clock is not allowed the property "adjusted time understood", it is against the rules to try to use it.

twelve o'clock.

I've got a moment before Drake spots me: he's just appeared, to the west.

>undo
East Refectory
[Previous turn undone.]

>set clock to quarter past three
*** Run-time problem P10: Since the Refectory Clock is not allowed the property "adjusted time understood", it is against the rules to try to use it.

*** Run-time problem P10: Since the Refectory Clock is not allowed the property "adjusted time understood", it is against the rules to try to use it.

I turn the clock hands to 
*** Run-time problem P10: Since the Refectory Clock is not allowed the property "adjusted time understood", it is against the rules to try to use it.

twelve o'clock.

Looking west, I can see Drake. He's coming this way!

>undo
East Refectory
[Previous turn undone.]

>set clock to jibber jabber
I didn't understand that time.

No, I can't set that to anything.

I've got a moment before Drake spots me: he's just appeared, to the west.

>undo
East Refectory
[Previous turn undone.]

>set clock to 11:15
*** Run-time problem P10: Since the Refectory Clock is not allowed the property "adjusted time understood", it is against the rules to try to use it.

*** Run-time problem P10: Since the Refectory Clock is not allowed the property "adjusted time understood", it is against the rules to try to use it.

I turn the clock hands to 
*** Run-time problem P10: Since the Refectory Clock is not allowed the property "adjusted time understood", it is against the rules to try to use it.

twelve o'clock.

I've got a moment before Drake spots me: he's just appeared, to the west.

>set clock to 11:15
*** Run-time problem P10: Since the Refectory Clock is not allowed the property "adjusted time understood", it is against the rules to try to use it.

The clock's already on 
*** Run-time problem P10: Since the Refectory Clock is not allowed the property "adjusted time understood", it is against the rules to try to use it.

twelve o'clock, thankfully enough.

*** Run-time problem P10: Since the Refectory Clock is not allowed the property "adjusted time understood", it is against the rules to try to use it.

I turn the clock hands to 
*** Run-time problem P10: Since the Refectory Clock is not allowed the property "adjusted time understood", it is against the rules to try to use it.

twelve o'clock.

"Wren!" Drake exclaims. He wallops me on the arm. "I thought I told you to stay in your room?" He doesn't wait for an excuse before I'm dragged off to the ladder. Then he waits - and wallops me - until I give in and climb all the way back up.

Attic Room
This isn't really an attic. It isn't really a room either. It's a couple of floorboards laid across some roof rafters right in the ceiling of the Abbey. There's enough floor-space for a cot and a laundry crate, but I have to be careful not to roll out of bed, because if I do, the thick cobwebs all around aren't going to stop me from falling….

A little hole in the ceiling provides some sunlight: and when it rains, it means I can wash my hair, too. It's right above the rickety ladder down to the ground (and that means the ladder is starting to rot and bend).

That was careless, getting caught. But I can still make it to the Cathedral. I'll just have to be more cunning this time. Remember, Wren, it's easy: the whole world runs on clockwork. Just a matter of staying ahead of the biting teeth.

>undo
East Refectory
[Previous turn undone.]

>set clock to 11:16
*** Run-time problem P10: Since the Refectory Clock is not allowed the property "adjusted time understood", it is against the rules to try to use it.

The clock's already on 
*** Run-time problem P10: Since the Refectory Clock is not allowed the property "adjusted time understood", it is against the rules to try to use it.

twelve o'clock, thankfully enough.

*** Run-time problem P10: Since the Refectory Clock is not allowed the property "adjusted time understood", it is against the rules to try to use it.

I turn the clock hands to 
*** Run-time problem P10: Since the Refectory Clock is not allowed the property "adjusted time understood", it is against the rules to try to use it.

twelve o'clock.

"Wren!" Drake exclaims. He wallops me on the arm. "I thought I told you to stay in your room?" He doesn't wait for an excuse before I'm dragged off to the ladder. Then he waits - and wallops me - until I give in and climb all the way back up.

Attic Room
This isn't really an attic. It isn't really a room either. It's a couple of floorboards laid across some roof rafters right in the ceiling of the Abbey. There's enough floor-space for a cot and a laundry crate, but I have to be careful not to roll out of bed, because if I do, the thick cobwebs all around aren't going to stop me from falling….

A little hole in the ceiling provides some sunlight: and when it rains, it means I can wash my hair, too. It's right above the rickety ladder down to the ground (and that means the ladder is starting to rot and bend).

That was careless, getting caught. But I can still make it to the Cathedral. I'll just have to be more cunning this time. Remember, Wren, it's easy: the whole world runs on clockwork. Just a matter of staying ahead of the biting teeth.

>undo
East Refectory
[Previous turn undone.]

>n
Kitchen
If there was ever a proof of the perfection of Clockwork over Nature, it's that the dirtiest and most hectic room in the whole Abbey is its Kitchen. Shelves, walls and floor are covered by machines belching, slicing, steaming, chopping, stirring, boiling, broiling, frying, pureeing … the list goes on. The noise, smell and heat is almost overpowering, and the Cook, who controls this madhouse, can only stand it because he's stone deaf.

I can escape back into the cool of the Hall to the west. South, through a broad arch, is the Refectory.

Drake's just off to the south, and he's coming this way!

>w
Upper Hall
The Great Hall of the Abbey is the biggest room I've seen in my life, running from this end all the way southwest (and it is all the way, I'm never allowed further) to the Great Doors and the Yard outside. If I crane my neck I can see the dark square of the floorboards of my room - the ladder is on one side, to the west. Lights move in and out overhead, from the candles moving on their Holy Tracks. Strong smells float through an archway to the east.

From their niches, the Three Major Saints are watching sternly, keen that I should get out of the Cathedral and talk to the Archbishop as quickly as possible.

I've got a moment before Drake spots me: he's just appeared, to the east.

>sw
Central Hall
I'm standing in the very centre of the Abbey's Great Hall. It's impossible not to crane my neck here, to gaze up at the ceiling held aloft by buttresses like gigantic oak trees. To think, people built this in the days before proper pulley-transmissions! It must have taken weeks! The hall continues northeast into shadow, and southwest, towards the sunlight, the Yard and above all, the Archbishop.

The vast empty space is filled by the muttering and echo of Holy Mechanisms, and the hiss of the candles as they sweep around their Tracks, providing a little light everywhere but rarely ever enough. I can just make out archways both east and west.

Looking northeast, I can see Drake. He's coming this way!

>e
West Refectory
I spend some of my time here, eating at one of the two long tables. I spend even more serving the monks. Each of them has their own seat, marked by a little brass hourglass, and if the twenty or so I can see here weren't enough (which they aren't), there's more to the east, where the Refectory continues. Back west is the archway to the Great Hall.

On the table is a single empty teacup, left over from breakfast.

>e
East Refectory
The eastern end of the long Refectory is given over in part to the tables lined with brass hourglasses, but in the other half there's nothing but the enormous Refectory Clock. It's an impressive thing, so big because it only needs winding once a year, despite all the gongs, cymbals, tubes and bells that strike when dinner time comes around. Right now, the clock is showing the time at just after five past twelve.

Pungent smells drift in from the kitchen to the north. On the east wall is the small green door to the Abbey's herb garden.

I can see a garden door here.

>set clock to 2:00
*** Run-time problem P10: Since the Refectory Clock is not allowed the property "adjusted time understood", it is against the rules to try to use it.

*** Run-time problem P10: Since the Refectory Clock is not allowed the property "adjusted time understood", it is against the rules to try to use it.

I turn the clock hands to 
*** Run-time problem P10: Since the Refectory Clock is not allowed the property "adjusted time understood", it is against the rules to try to use it.

twelve o'clock.

>set clock to 2:01
*** Run-time problem P10: Since the Refectory Clock is not allowed the property "adjusted time understood", it is against the rules to try to use it.

The clock's already on 
*** Run-time problem P10: Since the Refectory Clock is not allowed the property "adjusted time understood", it is against the rules to try to use it.

twelve o'clock, thankfully enough.

*** Run-time problem P10: Since the Refectory Clock is not allowed the property "adjusted time understood", it is against the rules to try to use it.

I turn the clock hands to 
*** Run-time problem P10: Since the Refectory Clock is not allowed the property "adjusted time understood", it is against the rules to try to use it.

twelve o'clock.

>set clock to 2:01
*** Run-time problem P10: Since the Refectory Clock is not allowed the property "adjusted time understood", it is against the rules to try to use it.

The clock's already on 
*** Run-time problem P10: Since the Refectory Clock is not allowed the property "adjusted time understood", it is against the rules to try to use it.

twelve o'clock, thankfully enough.

*** Run-time problem P10: Since the Refectory Clock is not allowed the property "adjusted time understood", it is against the rules to try to use it.

I turn the clock hands to 
*** Run-time problem P10: Since the Refectory Clock is not allowed the property "adjusted time understood", it is against the rules to try to use it.

twelve o'clock.

Drake's on patrol, and I can hear him heading this way, from the west.

>undo
East Refectory
[Previous turn undone.]

>e
I can't, since the garden door is in the way.

Drake's clattering boots are audible to the west.

>undo
East Refectory
[Previous turn undone.]

>n
Kitchen
If there was ever a proof of the perfection of Clockwork over Nature, it's that the dirtiest and most hectic room in the whole Abbey is its Kitchen. Shelves, walls and floor are covered by machines belching, slicing, steaming, chopping, stirring, boiling, broiling, frying, pureeing … the list goes on. The noise, smell and heat is almost overpowering, and the Cook, who controls this madhouse, can only stand it because he's stone deaf.

I can escape back into the cool of the Hall to the west. South, through a broad arch, is the Refectory.

The cook scurries past me, to unclip the broiler.

>w
Upper Hall
The Great Hall of the Abbey is the biggest room I've seen in my life, running from this end all the way southwest (and it is all the way, I'm never allowed further) to the Great Doors and the Yard outside. If I crane my neck I can see the dark square of the floorboards of my room - the ladder is on one side, to the west. Lights move in and out overhead, from the candles moving on their Holy Tracks. Strong smells float through an archway to the east.

From their niches, the Three Major Saints are watching sternly, keen that I should get out of the Cathedral and talk to the Archbishop as quickly as possible.

>sw
Central Hall
I'm standing in the very centre of the Abbey's Great Hall. It's impossible not to crane my neck here, to gaze up at the ceiling held aloft by buttresses like gigantic oak trees. To think, people built this in the days before proper pulley-transmissions! It must have taken weeks! The hall continues northeast into shadow, and southwest, towards the sunlight, the Yard and above all, the Archbishop.

The vast empty space is filled by the muttering and echo of Holy Mechanisms, and the hiss of the candles as they sweep around their Tracks, providing a little light everywhere but rarely ever enough. I can just make out archways both east and west.

>e
West Refectory
I spend some of my time here, eating at one of the two long tables. I spend even more serving the monks. Each of them has their own seat, marked by a little brass hourglass, and if the twenty or so I can see here weren't enough (which they aren't), there's more to the east, where the Refectory continues. Back west is the archway to the Great Hall.

On the table is a single empty teacup, left over from breakfast.

* * *

>e
East Refectory
The eastern end of the long Refectory is given over in part to the tables lined with brass hourglasses, but in the other half there's nothing but the enormous Refectory Clock. It's an impressive thing, so big because it only needs winding once a year, despite all the gongs, cymbals, tubes and bells that strike when dinner time comes around. Right now, the clock is showing the time at just after five past twelve.

Pungent smells drift in from the kitchen to the north. On the east wall is the small green door to the Abbey's herb garden.

I can see a garden door here.

>turn clock to 3:15
*** Run-time problem P10: Since the Refectory Clock is not allowed the property "adjusted time understood", it is against the rules to try to use it.

*** Run-time problem P10: Since the Refectory Clock is not allowed the property "adjusted time understood", it is against the rules to try to use it.

I turn the clock hands to 
*** Run-time problem P10: Since the Refectory Clock is not allowed the property "adjusted time understood", it is against the rules to try to use it.

twelve o'clock.

>turn clock to foobar
I didn't understand that time.

No, I can't set that to anything.

>l
East Refectory
The eastern end of the long Refectory is given over in part to the tables lined with brass hourglasses, but in the other half there's nothing but the enormous Refectory Clock. It's an impressive thing, so big because it only needs winding once a year, despite all the gongs, cymbals, tubes and bells that strike when dinner time comes around. Right now, the clock is showing the time at just after twelve o'clock.

Pungent smells drift in from the kitchen to the north. On the east wall is the small green door to the Abbey's herb garden.

I can see a garden door here.

>turn clock to foobar
I didn't understand that time.

No, I can't set that to anything.

>turn clock to 3:15
*** Run-time problem P10: Since the Refectory Clock is not allowed the property "adjusted time understood", it is against the rules to try to use it.

*** Run-time problem P10: Since the Refectory Clock is not allowed the property "adjusted time understood", it is against the rules to try to use it.

I turn the clock hands to 
*** Run-time problem P10: Since the Refectory Clock is not allowed the property "adjusted time understood", it is against the rules to try to use it.

twelve o'clock.

Drake's clattering boots are audible to the west.

>l
East Refectory
The eastern end of the long Refectory is given over in part to the tables lined with brass hourglasses, but in the other half there's nothing but the enormous Refectory Clock. It's an impressive thing, so big because it only needs winding once a year, despite all the gongs, cymbals, tubes and bells that strike when dinner time comes around. Right now, the clock is showing the time at just after twelve o'clock.

Pungent smells drift in from the kitchen to the north. On the east wall is the small green door to the Abbey's herb garden.

I can see a garden door here.

I've got a moment before Drake spots me: he's just appeared, to the west.

>turn clock to 3:30
Drake's footsteps echo in from the west.

>undo
East Refectory
[Previous turn undone.]

>turn clock to 3:31
Drake's footsteps echo in from the west.

>undo
East Refectory
[Previous turn undone.]

>turn clock to 3:29
Drake's footsteps echo in from the west.

>undo
East Refectory
[Previous turn undone.]

>turn clock to 15:30
Drake's footsteps echo in from the west.

>undo
East Refectory
[Previous turn undone.]

>turn clock to 15:31
The clock's already on twenty-nine minutes to four, thankfully enough.

Drake's clattering boots are audible to the west.

>turn clock to 3:29 pm
I've got a moment before Drake spots me: he's just appeared, to the west.

>undo
East Refectory
[Previous turn undone.]

>turn clock to 3:32 pm
The clock's already on twenty-eight minutes to four, thankfully enough.

Looking west, I can see Drake. He's coming this way!

>undo
East Refectory
[Previous turn undone.]

* * *

>set clock to 3:15
I turn the clock hands to quarter past three.

Drake's just off to the west, and he's coming this way!

>set clock to 3:15 PM
The clock's already on quarter past three, thankfully enough.

"Wren!" Drake exclaims. He wallops me on the arm. "I thought I told you to stay in your room?" He doesn't wait for an excuse before I'm dragged off to the ladder. Then he waits - and wallops me - until I give in and climb all the way back up.

Attic Room
This isn't really an attic. It isn't really a room either. It's a couple of floorboards laid across some roof rafters right in the ceiling of the Abbey. There's enough floor-space for a cot and a laundry crate, but I have to be careful not to roll out of bed, because if I do, the thick cobwebs all around aren't going to stop me from falling….

A little hole in the ceiling provides some sunlight: and when it rains, it means I can wash my hair, too. It's right above the rickety ladder down to the ground (and that means the ladder is starting to rot and bend).

That was careless, getting caught. But I can still make it to the Cathedral. I'll just have to be more cunning this time. Remember, Wren, it's easy: the whole world runs on clockwork. Just a matter of staying ahead of the biting teeth.

>undo
East Refectory
[Previous turn undone.]

>x clock
Housed in a case made of oak and glass, the inner workings of the Refectory Clock are visible, for the purpose of contemplation over dinner. In one corner is the colossal spring, about the size of an Oliphant, which powers the clock for over a year and reminds us that we need little to do much. Almost all the rest of the clock is given over to bells, hammers, whistles, gongs, organ pipes, cymbals, and other devices designed to bring even the deafest monk to dinner.

The clock is currently set to sixteen minutes past three.

"Wren!" Drake exclaims. He wallops me on the arm. "I thought I told you to stay in your room?" He doesn't wait for an excuse before I'm dragged off to the ladder. Then he waits - and wallops me - until I give in and climb all the way back up.

Attic Room
This isn't really an attic. It isn't really a room either. It's a couple of floorboards laid across some roof rafters right in the ceiling of the Abbey. There's enough floor-space for a cot and a laundry crate, but I have to be careful not to roll out of bed, because if I do, the thick cobwebs all around aren't going to stop me from falling….

A little hole in the ceiling provides some sunlight: and when it rains, it means I can wash my hair, too. It's right above the rickety ladder down to the ground (and that means the ladder is starting to rot and bend).

That was careless, getting caught. But I can still make it to the Cathedral. I'll just have to be more cunning this time. Remember, Wren, it's easy: the whole world runs on clockwork. Just a matter of staying ahead of the biting teeth.

>undo
East Refectory
[Previous turn undone.]

>set clock to 3:16
I turn the clock hands to sixteen minutes past three.

"Wren!" Drake exclaims. He wallops me on the arm. "I thought I told you to stay in your room?" He doesn't wait for an excuse before I'm dragged off to the ladder. Then he waits - and wallops me - until I give in and climb all the way back up.

Attic Room
This isn't really an attic. It isn't really a room either. It's a couple of floorboards laid across some roof rafters right in the ceiling of the Abbey. There's enough floor-space for a cot and a laundry crate, but I have to be careful not to roll out of bed, because if I do, the thick cobwebs all around aren't going to stop me from falling….

A little hole in the ceiling provides some sunlight: and when it rains, it means I can wash my hair, too. It's right above the rickety ladder down to the ground (and that means the ladder is starting to rot and bend).

That was careless, getting caught. But I can still make it to the Cathedral. I'll just have to be more cunning this time. Remember, Wren, it's easy: the whole world runs on clockwork. Just a matter of staying ahead of the biting teeth.

>undo
East Refectory
[Previous turn undone.]

>set clock to 3:15
The clock's already on quarter past three, thankfully enough.

"Wren!" Drake exclaims. He wallops me on the arm. "I thought I told you to stay in your room?" He doesn't wait for an excuse before I'm dragged off to the ladder. Then he waits - and wallops me - until I give in and climb all the way back up.

Attic Room
This isn't really an attic. It isn't really a room either. It's a couple of floorboards laid across some roof rafters right in the ceiling of the Abbey. There's enough floor-space for a cot and a laundry crate, but I have to be careful not to roll out of bed, because if I do, the thick cobwebs all around aren't going to stop me from falling….

A little hole in the ceiling provides some sunlight: and when it rains, it means I can wash my hair, too. It's right above the rickety ladder down to the ground (and that means the ladder is starting to rot and bend).

That was careless, getting caught. But I can still make it to the Cathedral. I'll just have to be more cunning this time. Remember, Wren, it's easy: the whole world runs on clockwork. Just a matter of staying ahead of the biting teeth.

>undo
East Refectory
[Previous turn undone.]

>set clock to 3:15 AM
The clock's already on quarter past three, thankfully enough.

"Wren!" Drake exclaims. He wallops me on the arm. "I thought I told you to stay in your room?" He doesn't wait for an excuse before I'm dragged off to the ladder. Then he waits - and wallops me - until I give in and climb all the way back up.

Attic Room
This isn't really an attic. It isn't really a room either. It's a couple of floorboards laid across some roof rafters right in the ceiling of the Abbey. There's enough floor-space for a cot and a laundry crate, but I have to be careful not to roll out of bed, because if I do, the thick cobwebs all around aren't going to stop me from falling….

A little hole in the ceiling provides some sunlight: and when it rains, it means I can wash my hair, too. It's right above the rickety ladder down to the ground (and that means the ladder is starting to rot and bend).

That was careless, getting caught. But I can still make it to the Cathedral. I'll just have to be more cunning this time. Remember, Wren, it's easy: the whole world runs on clockwork. Just a matter of staying ahead of the biting teeth.

>d
I scramble quickly down the ladder.

Rickety Stair
I'm in one corner of the Great Hall, just by the foot of the ladder up to my room. There's a note attached to it, asking Amble the caretaker not to put it back in the shed just yet.

>e
I catch the sound of hobnailed boots. Drake's heading this way! I'd better wait, and let him pass.

>e
Just in time, I see Drake's there. I hang back, to let him move on.

* * *

>e
Kitchen
If there was ever a proof of the perfection of Clockwork over Nature, it's that the dirtiest and most hectic room in the whole Abbey is its Kitchen. Shelves, walls and floor are covered by machines belching, slicing, steaming, chopping, stirring, boiling, broiling, frying, pureeing … the list goes on. The noise, smell and heat is almost overpowering, and the Cook, who controls this madhouse, can only stand it because he's stone deaf.

I can escape back into the cool of the Hall to the west. South, through a broad arch, is the Refectory.

>s
East Refectory
The eastern end of the long Refectory is given over in part to the tables lined with brass hourglasses, but in the other half there's nothing but the enormous Refectory Clock. It's an impressive thing, so big because it only needs winding once a year, despite all the gongs, cymbals, tubes and bells that strike when dinner time comes around. Right now, the clock is showing the time at just after twenty past three.

Pungent smells drift in from the kitchen to the north. On the east wall is the small green door to the Abbey's herb garden.

I can see a garden door here.

* * *

>w
The Abbot's voice is getting nearer… If he sees I've been in here, he'll have me turning the paddles in the laundry room for a month! There's nothing for it, I'll have to escape.

The Abbot's voice is getting closer. The old man may move slower than a short hand, but he's definitely coming this way.

>w
The Abbot's voice is getting nearer… If he sees I've been in here, he'll have me turning the paddles in the laundry room for a month! There's nothing for it, I'll have to escape.

Oh, widdershins! Gubbler is right outside the door! I'd better hide!

>w
The Abbot's voice is getting nearer… If he sees I've been in here, he'll have me turning the paddles in the laundry room for a month! There's nothing for it, I'll have to escape.

"We'll talk in here," I hear the Abbot saying, from right outside the door. "More private. More quiet. Much better." The old man steps inside the room, followed by a tall figure in grey. In the last tick before his old eyes can see me, I dive inside the gigantic clock case and pull closed the door.

Inside Clock Case
As the phrase goes, I'm stuck between a rack and a gear-trace; except here I'm in the narrow gap between the clock case door and the heavy swinging penduluum behind. And if that hit me, and disrupted the holy timings… well, there's no way they wouldn't notice when the clock-hands stopped moving, let's just say.

A little light shines in through the keyhole, which is almost covered by the Abbot's spare robe.

Oh, no… That click outside was the sound of the Abbot closing the door. Looks like he - and the grey figure I glimpsed with him - are going to be here for a while…

>w
I can't go that way.

"I told you now didn't I tell you?" old Abbot Gubbler is saying, plaintively. "Here? Why here? You shouldn't have come here."

The Figure says something in reply. I can only hear two words, but they're enough to stop my heart. "Failure," and "Consequences."

>out
I can't, since Gubbler's Grandfather clock is in the way.

"But these things, these things are not always tick-tock, they never are," the old man replies. His voice is quivering, quite different from the steady drone he has when intoning in Chapel. "The - item you asked about - it's in the Vaults, you see? The Vaults. Even if I could get in, I …"

The Figure is too far from the keyhole and speaks too quietly for me to hear clearly. "Disappointing," he says; and then "unslip your gears."

>open clock
I open Gubbler's Grandfather clock.

The Abbot is spluttering and choking. You've seen him like this only once, when as a young initiate you dropped and smashed an altimeter right before the Archbishop was due to visit.

The Figure's quiet voice continues. I can make out; "too old to steal", "a better mechanism", "the opportunity."

The Abbot nods violently, shaking out agreement the way I might beat dirt from a duster. "My money?" he asks.

* * *

>w
The Abbot's voice is getting nearer… If he sees I've been in here, he'll have me turning the paddles in the laundry room for a month! There's nothing for it, I'll have to escape.

The Abbot's voice is getting closer. The old man may move slower than a short hand, but he's definitely coming this way.

>hide in clock
"We'll talk in here," I hear the Abbot saying, from right outside the door. "More private. More quiet. Much better." The old man steps inside the room, followed by a tall figure in grey. In the last tick before his old eyes can see me, I dive inside the gigantic clock case and pull closed the door.

Inside Clock Case
As the phrase goes, I'm stuck between a rack and a gear-trace; except here I'm in the narrow gap between the clock case door and the heavy swinging penduluum behind. And if that hit me, and disrupted the holy timings… well, there's no way they wouldn't notice when the clock-hands stopped moving, let's just say.

A little light shines in through the keyhole, which is almost covered by the Abbot's spare robe.

Oh, no… That click outside was the sound of the Abbot closing the door. Looks like he - and the grey figure I glimpsed with him - are going to be here for a while…

>look through keyhole
I can make out the Abbot's hands, which are shaking badly. But I can see nothing of the Figure.

"I told you now didn't I tell you?" old Abbot Gubbler is saying, plaintively. "Here? Why here? You shouldn't have come here."

The Figure says something in reply. I can only hear two words, but they're enough to stop my heart. "Failure," and "Consequences."

>out
You've got a spring missing if you think I can slip out, unnoticed, or come up with a decent excuse as to why I've been hiding in the Abbot's grandfather. No, I'm staying put and hoping nothing happens to make the old man need to change his clothes.

"But these things, these things are not always tick-tock, they never are," the old man replies. His voice is quivering, quite different from the steady drone he has when intoning in Chapel. "The - item you asked about - it's in the Vaults, you see? The Vaults. Even if I could get in, I …"

The Figure is too far from the keyhole and speaks too quietly for me to hear clearly. "Disappointing," he says; and then "unslip your gears."

>listen with tumbler
Oh… well, then. I tip out the last of the polish onto the floor of the clock. At least that part will shine.

I put the glass tumbler carefully against the door, then lean down to press my ear against it. Fantastic! I can hear much more clearly now!

The Abbot is spluttering and choking. You've seen him like this only once, when as a young initiate you dropped and smashed an altimeter right before the Archbishop was due to visit.

The Figure continues. "Clearly you're too old to steal the item for us. We have a better mechanism for obtaining it. But you must provide us with the opportunity. Is that understood?"

The Abbot nods violently, shaking out agreement the way I might beat dirt from a duster. "My money?" he asks.

>out
You've got a spring missing if you think I can slip out, unnoticed, or come up with a decent excuse as to why I've been hiding in the Abbot's grandfather. No, I'm staying put and hoping nothing happens to make the old man need to change his clothes.

There's the clink, of a pouch of golden minutes. A heavy pouch. The Figure, paying the Abbot…? Then suddenly, there's a third voice. "Sorry, Father, to interrupt, but you said…"

It's a monk of the Abbey. "Get out!" the Abbot screeches. His bearing's lost its oil, it seems. "Get out, get out!"

"But Father," the monk continues, "it's time, you know. You told me to tell you when it was time."

"Oh! Of course of course," he mumbles. "I'll… We'll continue this discussion later, then," he says, to the Figure.

"We certainly will," the Figure replies.

The Abbot leaves, and that leaves me alone, inside this clock, with the stranger outside. He's coming nearer… I can hear his fingers on the door of the case! I must have nudged the penduluum, he must have seen the clock-hands quiver… but then, there's the swish of his cloak as he moves away, and the click as the door closes. Phew.

>out
I spill gratefully out of the clock, gasping for breath as though I've been underwater. I've just been holding it in, of course. As what I've heard - well, I probably shouldn't have, and the quicker I can get out of here, the better.

Abbot's Quarters
If I thought Abbots lived in luxury, then I was dead wrong. Even my attic's cosier than this. The Abbot's got no furniture at all, except a desk and a cot, and no decoration except for a bust of St. Newton. None of the axle-mounted bevelled mobiles I was expecting. There's barely even any sunlight: one thin window to catch the sun-rise, opposite the door to the hallway back west.

St. Newton is staring at the Abbot's unpolished Grandfather clock with a severe frown.

* * *

>sw
Central Hall
I'm standing in the very centre of the Abbey's Great Hall. It's impossible not to crane my neck here, to gaze up at the ceiling held aloft by buttresses like gigantic oak trees. To think, people built this in the days before proper pulley-transmissions! It must have taken weeks! The hall continues northeast into shadow, and southwest, towards the sunlight, the Yard and above all, the Archbishop.

The vast empty space is filled by the muttering and echo of Holy Mechanisms, and the hiss of the candles as they sweep around their Tracks, providing a little light everywhere but rarely ever enough. I can just make out archways both east and west.

Looking west, I can see Drake. He's coming this way!

>sw
Lower Hall
Looking northeast, the Great Hall of the Abbey stretches away like the belly of some big beast, its bony roof held up by pillars like swallowed trees. The walls are carelessly lit by candles moving through Sacred Tracks suspended in the air. I can just make out the Corridor of Contemplation to the east, and the wider archway to the Scriptorium to the west.

But more importantly, the great Entry - and exit - of the Abbey is to the southwest. And if I'm going to get out of here and talk to the Archbishop that's the only way to go.

But maybe you're starting to see what kind of luck I have. Right there, in the Entry, is Calvin, working on a clock.

* * *

>ne
Library
The Abbey's library is small compared to the one in the Cathedral. There's nothing on the shelves but the key texts: the Principia, the Mechanistica and the Determininium. Only Brother Horloge, the Abbey's Primary Reader ever seems to use them - he's here at the moment, studying at his desk by the poor light coming through the stained glass windows. By his elbow is a fat bunch of keys. On his shoulder is his mechanical owl, wings folded.

An archway leads east back into the hall. From the southwest comes the clatter of Writing hammers and the sharp smell of burnt ink.

>x light
I can't see any such thing.

>x windows
I can't see any such thing.

>x window
The glass panels are stained to depict a watch escapement, an astrolabe and below them both, the wide-spread arms of a beatific orrey. Not much light gets through them at all.

* * *

>w
Curses to counterweights! It's not on my rota, this clock, so why should I finish off my polish on it? I head for the doorway - then freeze. Voices, coming down the hall. It's the Abbot himself, coming this way!

>enter clocki
I can't see any such thing.

>enter clock
"We'll talk in here," I hear the Abbot saying, from right outside the door. "More private. More quiet. Much better." The old man steps inside the room, followed by a tall figure in grey. In the last tick before his old eyes can see me, I dive inside the gigantic clock case and pull closed the door.

Inside Clock Case
As the phrase goes, I'm stuck between a rack and a gear-trace; except here I'm in the narrow gap between the clock case door and the heavy swinging penduluum behind. And if that hit me, and disrupted the holy timings… well, there's no way they wouldn't notice when the clock-hands stopped moving, let's just say.

A little light shines in through the keyhole, which is almost covered by the Abbot's spare robe.

Oh, no… That click outside was the sound of the Abbot closing the door. Looks like he - and the grey figure I glimpsed with him - are going to be here for a while…

>use tumbler
That's not a verb I recognize.

>listen with tumbler
Oh… well, then. I tip out the last of the polish onto the floor of the clock. At least that part will shine.

I put the glass tumbler carefully against the door, then lean down to press my ear against it. Fantastic! I can hear much more clearly now!

"I told you now didn't I tell you?" old Abbot Gubbler is saying, plaintively. "Here? Why here? You shouldn't have come here."

The Figure says something in reply. With the glass, I can hear quite clearly. That was a good idea. "We have been disappointed with your failure. The cause and effect principle, Abbot. Such failure must bring consequences."

* * *

>z
Time passes.

>w
Rickety Stair
I'm in one corner of the Great Hall, just by the foot of the ladder up to my room. There's a note attached to it, asking Amble the caretaker not to put it back in the shed just yet.

>undo
Upper Hall
[Previous turn undone.]

>sw
Central Hall
I'm standing in the very centre of the Abbey's Great Hall. It's impossible not to crane my neck here, to gaze up at the ceiling held aloft by buttresses like gigantic oak trees. To think, people built this in the days before proper pulley-transmissions! It must have taken weeks! The hall continues northeast into shadow, and southwest, towards the sunlight, the Yard and above all, the Archbishop.

The vast empty space is filled by the muttering and echo of Holy Mechanisms, and the hiss of the candles as they sweep around their Tracks, providing a little light everywhere but rarely ever enough. I can just make out archways both east and west.

* * *

>e
West Refectory
I spend some of my time here, eating at one of the two long tables. I spend even more serving the monks. Each of them has their own seat, marked by a little brass hourglass, and if the twenty or so I can see here weren't enough (which they aren't), there's more to the east, where the Refectory continues. Back west is the archway to the Great Hall.

On the table is a single empty teacup, left over from breakfast.

>e
East Refectory
The eastern end of the long Refectory is given over in part to the tables lined with brass hourglasses, but in the other half there's nothing but the enormous Refectory Clock. It's an impressive thing, so big because it only needs winding once a year, despite all the gongs, cymbals, tubes and bells that strike when dinner time comes around. Right now, the clock is showing the time at just after seventeen minutes past three.

Pungent smells drift in from the kitchen to the north. On the east wall is the small green door to the Abbey's herb garden.

I can see a refectory clock here.

>w
West Refectory
I spend some of my time here, eating at one of the two long tables. I spend even more serving the monks. Each of them has their own seat, marked by a little brass hourglass, and if the twenty or so I can see here weren't enough (which they aren't), there's more to the east, where the Refectory continues. Back west is the archway to the Great Hall.

On the table is a single empty teacup, left over from breakfast.

>get cup
I pick up the empty cup from its place beside by Brother Horloge's hourglass.

>l
West Refectory
I spend some of my time here, eating at one of the two long tables. I spend even more serving the monks. Each of them has their own seat, marked by a little brass hourglass, and if the twenty or so I can see here weren't enough (which they aren't), there's more to the east, where the Refectory continues. Back west is the archway to the Great Hall.

>e
East Refectory
The eastern end of the long Refectory is given over in part to the tables lined with brass hourglasses, but in the other half there's nothing but the enormous Refectory Clock. It's an impressive thing, so big because it only needs winding once a year, despite all the gongs, cymbals, tubes and bells that strike when dinner time comes around. Right now, the clock is showing the time at just after twenty-one minutes past three.

Pungent smells drift in from the kitchen to the north. On the east wall is the small green door to the Abbey's herb garden.

I can see a refectory clock here.

* * *

>w
Curses to counterweights! It's not on my rota, this clock, so why should I finish off my polish on it? I head for the doorway - then freeze. Voices, coming down the hall. It's the Abbot himself, coming this way!

>hide behind the clock
No space behind - but plenty inside. "We'll talk in here," I hear the Abbot saying, from right outside the door. "More private. More quiet. Much better." The old man steps inside the room, followed by a tall figure in grey. In the last tick before his old eyes can see me, I dive inside the gigantic clock case and pull closed the door.

Inside Clock Case
As the phrase goes, I'm stuck between a rack and a gear-trace; except here I'm in the narrow gap between the clock case door and the heavy swinging penduluum behind. And if that hit me, and disrupted the holy timings… well, there's no way they wouldn't notice when the clock-hands stopped moving, let's just say.

A little light shines in through the keyhole, which is almost covered by the Abbot's spare robe.

Oh, no… That click outside was the sound of the Abbot closing the door. Looks like he - and the grey figure I glimpsed with him - are going to be here for a while…

>put  the glass on the door
Oh… well, then. I tip out the last of the polish onto the floor of the clock. At least that part will shine.

I put the glass tumbler carefully against the door, then lean down to press my ear against it. Fantastic! I can hear much more clearly now!

"I told you now didn't I tell you?" old Abbot Gubbler is saying, plaintively. "Here? Why here? You shouldn't have come here."

The Figure says something in reply. With the glass, I can hear quite clearly. That was a good idea. "We have been disappointed with your failure. The cause and effect principle, Abbot. Such failure must bring consequences."

>listen to the conversation with the glass
The tumbler is already fast against the door.

"But these things, these things are not always tick-tock, they never are," the old man replies. His voice is quivering, quite different from the steady drone he has when intoning in Chapel. "The - item you asked about - it's in the Vaults, you see? The Vaults. Even if I could get in, I …"

"Your excuses we find disappointing. Very disappointing. More of this and, Abbot, we may need to unslip your gears completely."

>listen to the conversation
I put one ear to the keyhole but the Figure's voice is still too faint. But that's right and proper, isn't it? I shouldn't be eavesdropping on the Abbot's private conferences! I'd better just wait till he goes.

The Abbot is spluttering and choking. I've seen him like this only once, when as a young initiate I dropped and smashed an altimeter right before the Archbishop was due to visit.

The Figure continues. "Clearly you're too old to steal the item for us. We have a better mechanism for obtaining it. But you must provide us with the opportunity. Is that understood?"

The Abbot nods violently, shaking out agreement the way I might beat dirt from a duster. "My money?" he asks.

>x the conversation
I can make out the Abbot's hands, which are shaking badly. But I can see nothing of the Figure. 

There's the clink, of a pouch of golden minutes. A heavy pouch. The Figure, paying the Abbot…? Then suddenly, there's a third voice. "Sorry, Father, to interrupt, but you said…"

It's a monk of the Abbey. "Get out!" the Abbot screeches. His bearing's lost its oil, it seems. "Get out, get out!"

"But Father," the monk continues, "it's time, you know. You told me to tell you when it was time."

"Oh! Of course of course," he mumbles. "I'll… We'll continue this discussion later, then," he says, to the Figure.

"We certainly will," the Figure replies.

The Abbot leaves, and that leaves me alone, inside this clock, with the stranger outside. He's coming nearer… I can hear his fingers on the door of the case! I must have nudged the penduluum, he must have seen the clock-hands quiver… but then, there's the swish of his cloak as he moves away, and the click as the door closes. Phew.

>out
I spill gratefully out of the clock, gasping for breath as though I've been underwater. I've just been holding it in, of course. As what I've heard - well, I probably shouldn't have, and the quicker I can get out of here, the better.

Abbot's Quarters
I need to get out of this place as fast as I can and without attracting any more  attention. The door to the hallway is back east and as for polishing the  Grandfather clock - well, forget it!

St. Newton is staring at the Abbot's unpolished Grandfather clock with a severe frown.

>l
Abbot's Quarters
I need to get out of this place as fast as I can and without attracting any more  attention. The door to the hallway is back east and as for polishing the  Grandfather clock - well, forget it!

St. Newton is staring at the Abbot's unpolished Grandfather clock with a severe frown.

>w
I'm going to have to tell someone what I just heard. A theft, from the Vaults! But if the Abbot's involved - then who else might be? After all, the figure he was talking to could have been anyone in the Abbey!

Corridor of Contemplation
The ancient stones of the Abbey rise to about shoulder-height before arching over, forcing me to bow my head in supplication before the Abbot's door, back east. To the west, I can hear the gentle echo of ticks and tocks coming from the Abbey's main hall.

Carved into the walls are a series of pious engravings, depicting the long path from initiate to Abbot.

>w
I dart out of the tunnel, only to be stopped dead by a depressing sight. It's Calvin and Drake, hurrying in through the Abbey's Great Entry. Their mouths are white with sugar.

"Hey, you!" Drake shouts. In a moment he's got me by the ear. "What were you doing in the Abbot's room? That's not on your rota!"

"Yeah!" Calvin adds. "And why are you slipping away when we told you to be there?"

"Idiot," Drake hisses. Louder - for the benefit of any passing monks - he says, "That's it, Wren. You're consigned to your room." For good measure, he punches me on the arm, then the two of them drag me away, heels over flagstones, right to the bottom of the ladder.

"Up you go," Calvin says. "And you're not to come down till dark!"

"What about dinner?" I ask.

"Should have thought of that, shouldn't you?" Drake says.

"More for us," Calvin adds. "Only two hours to go. I'm starved."

With that, they punch me again, and wait until I scurry away up the ladder.

Attic Room
This isn't really an attic. It isn't really a room either. It's a couple of floorboards laid across some roof rafters right in the ceiling of the Abbey. There's enough floor-space for a cot and a laundry crate, but I have to be careful not to roll out of bed, because if I do, the thick cobwebs all around aren't going to stop me from falling…

A little hole in the ceiling provides some sunlight: and when it rains, it means I can wash my hair, too. It's right above the rickety ladder down to the ground (and that means the ladder is starting to rot and bend).

Through my window I can see the Cathedral across the yard outside. If I was a bird, I could escape easily, and tell someone what I've overheard. The Abbot's about to do something terrible and I've got to stop him! Someone at the Cathedral would listen: the Archbishop himself, perhaps. He might remember me from the time he visited, when he helped me repair an altimeter I'd broken. If only I could fly.

But perhaps I can escape on foot. If I'm clever. Clockwise.

>d
I scramble quickly down the ladder.

Rickety Stair
I'm in the western corner of the Great Hall, just by the foot of the ladder up to my room. There's a note attached to it, asking Amble the caretaker not to put it back in the shed just yet.

>e
Upper Hall
The Great Hall of the Abbey is the biggest room I've seen in my life, running from this end all the way southwest (and it is all the way, I'm never allowed any further than the Great Doors and the Yard outside). If I crane my neck I can see the dark square of the floorboards of my room - the ladder is on one side, to the west. Lights move in and out overhead, from the candles moving on their Holy Tracks. Strong smells float through an archway to the east.

From their niches, the Three Major Saints are watching sternly, keen that I should get out of the Cathedral and talk to the Archbishop as quickly as possible.

>e
Kitchen
If there was ever a proof of the perfection of Clockwork over Nature, it's that the dirtiest and most hectic room in the whole Abbey is its Kitchen. Shelves, walls and floor are covered by machines belching, slicing, steaming, chopping, stirring, boiling, broiling, frying, pureeing … the list goes on. The noise, smell and heat is almost overpowering, and the Cook, who controls this madhouse, can only stand it because he's stone deaf.

I can escape back into the cool of the Hall to the west. South, through a broad arch, is the Refectory.

The cook pushes past me, to wind the grater.

>s
East Refectory
The eastern end of the long Refectory is given over in part to the tables lined with brass hourglasses, but in the other half there's nothing but the enormous Refectory Clock. It's an impressive thing, so big because it only needs winding once a year, despite all the gongs, cymbals, tubes and bells that strike when dinner time comes around. Right now, the clock is showing the time at just after quarter past three.

Pungent smells drift in from the kitchen to the north. On the east wall is the small green door to the Abbey's herb garden.

>x the hourglasses
Little polished hourglasses, each with a name inscribed at the base. They run on a metal bar so they can be easily flipped. "There is time for eating," so they say, "but only the right amount of time."

>w
West Refectory
I spend some of my time here, eating at one of the two long tables. I spend even more serving the monks. Each of them has their own seat, marked by a little brass hourglass, and if the twenty or so I can see here weren't enough (which they aren't), there's more to the east, where the Refectory continues. Back west is the archway to the Great Hall.

On the table is a single empty teacup, left over from breakfast.

Distantly - but not distantly enough - I can hear the clock and clatter of Drake's boots. The sound's coming from the west.

>x the hourglasses
Little polished hourglasses, each with a name inscribed at the base. They run on a metal bar so they can be easily flipped. "There is time for eating," so they say, "but only the right amount of time." Next to Horloge's hourglass is an empty tea cup. 

Looking west, I can see Drake. He's coming this way!

>undo
West Refectory
[Previous turn undone.]

>x drake
He looks mean, and like he's doing the loop hoping to look busy enough not get a clip round the ear, which is what I'm about to get...

I see nothing special about Drake.

I've got a moment before Drake spots me: he's just appeared, to the west.

>talk to drak
That's not a verb I recognize.

>talk to drake
That's not a verb I recognize.

>ask drake about me
He's far away and I want to keep it that way.

I can't reach into Central Hall.

"Wren!" Drake exclaims. He wallops me on the arm. "I thought I told you to stay in your room?" He doesn't wait for an excuse before I'm dragged off to the ladder. Then he waits - and wallops me - until I give in and climb all the way back up.

Attic Room
Back in the attic. The Cathedral is still just as far away, visible through the  hole in the ceiling above my cot. But the ladder's the only way out of here.

That was careless, getting caught. But I can still make it to the Cathedral. I'll just have to be more cunning this time. Remember, Wren, it's easy: the whole world runs on clockwork. Just a matter of staying ahead of the biting teeth.

>d
I scramble quickly down the ladder.

Rickety Stair
I'm in the western corner of the Great Hall, just by the foot of the ladder up to my room. There's a note attached to it, asking Amble the caretaker not to put it back in the shed just yet.

>x the ladder
One of the old construction ladders left over from the building of the Abbey. It's a real antique. Some rungs are missing and the middle bends inwards. I can still climb it in my sleep, of course. The ladder leads up to my room.

>s
I can't go that way.

>e
I catch the sound of hobnailed boots. Drake's heading this way! I'd better wait, and let him pass.

>e
I catch the sound of hobnailed boots. Drake's heading this way! I'd better wait, and let him pass.

* * *

>e
Just in time, I see Drake's there. I hang back, to let him move on.

>e
Upper Hall
The Great Hall of the Abbey is the biggest room I've seen in my life, running from this end all the way southwest (and it is all the way, I'm never allowed any further than the Great Doors and the Yard outside). If I crane my neck I can see the dark square of the floorboards of my room - the ladder is on one side, to the west. Lights move in and out overhead, from the candles moving on their Holy Tracks. Strong smells float through an archway to the east.

From their niches, the Three Major Saints are watching sternly, keen that I should get out of the Cathedral and talk to the Archbishop as quickly as possible.

>tree drake
Which do I mean, Drake or Calvin and Drake?

>e
I only understood you as far as wanting to tree the east.

>ne
I can't go that way.

>e
Kitchen
If there was ever a proof of the perfection of Clockwork over Nature, it's that the dirtiest and most hectic room in the whole Abbey is its Kitchen. Shelves, walls and floor are covered by machines belching, slicing, steaming, chopping, stirring, boiling, broiling, frying, pureeing … the list goes on. The noise, smell and heat is almost overpowering, and the Cook, who controls this madhouse, can only stand it because he's stone deaf.

I can escape back into the cool of the Hall to the west. South, through a broad arch, is the Refectory.

The cook knocks past me, to unclip the crumb-sucker.

>x the cook
The story goes that the Cook lost his hearing while setting rat-traps inside the great Refectory Clock. He'd been late about his chores and so instead of being there at 4.30 like his rota told him to, he was there at 5.00. When the gongs ran for dinner, he was still inside the case. If it's true, then never mind his ears, it's a wonder he can still see or think. That clock is seriously loud. 

The cook scurries past me, to wind the grater.

>g
The story goes that the Cook lost his hearing while setting rat-traps inside the great Refectory Clock. He'd been late about his chores and so instead of being there at 4.30 like his rota told him to, he was there at 5.00. When the gongs ran for dinner, he was still inside the case. If it's true, then never mind his ears, it's a wonder he can still see or think. That clock is seriously loud. 

The cook pushes past me, to unclip the steamer.

>s
East Refectory
The eastern end of the long Refectory is given over in part to the tables lined with brass hourglasses, but in the other half there's nothing but the enormous Refectory Clock. It's an impressive thing, so big because it only needs winding once a year, despite all the gongs, cymbals, tubes and bells that strike when dinner time comes around. Right now, the clock is showing the time at just after half past three.

Pungent smells drift in from the kitchen to the north. On the east wall is the small green door to the Abbey's herb garden.

>w
West Refectory
I spend some of my time here, eating at one of the two long tables. I spend even more serving the monks. Each of them has their own seat, marked by a little brass hourglass, and if the twenty or so I can see here weren't enough (which they aren't), there's more to the east, where the Refectory continues. Back west is the archway to the Great Hall.

On the table is a single empty teacup, left over from breakfast.

Drake's just off to the west, and he's coming this way!

>w
Just in time, I see Drake's there. I hang back, to let him move on.

Drake looks like he's swallowed a bee. Not only have I disobeyed him, but I've done it twice. "I'm going to have your skin," he hisses into in my ear. "I'm going to use it as a cloak come winter. Understand?" With that he drags me back off to my attic. This time, I can barely climb the stairs.

Attic Room
Back in the attic. The Cathedral is still just as far away, visible through the  hole in the ceiling above my cot. But the ladder's the only way out of here.

A quick pause for breath and… right then. I'm ready. I'm going to get out of the Abbey somehow, and warn the Archbishop. And I won't give up till I've got there!

* * *

>w
Curses to counterweights! It's not on my rota, this clock, so why should I finish off my polish on it? I head for the doorway - then freeze. Voices, coming down the hall. It's the Abbot himself, coming this way!

>hide
What do I want to hide behind?

>clock
No space behind - but plenty inside. "We'll talk in here," I hear the Abbot saying, from right outside the door. "More private. More quiet. Much better." The old man steps inside the room, followed by a tall figure in grey. In the last tick before his old eyes can see me, I dive inside the gigantic clock case and pull closed the door.

Inside Clock Case
As the phrase goes, I'm stuck between a rack and a gear-trace; except here I'm in the narrow gap between the clock case door and the heavy swinging penduluum behind. And if that hit me, and disrupted the holy timings… well, there's no way they wouldn't notice when the clock-hands stopped moving, let's just say.

A little light shines in through the keyhole, which is almost covered by the Abbot's spare robe.

Oh, no… That click outside was the sound of the Abbot closing the door. Looks like he - and the grey figure I glimpsed with him - are going to be here for a while…

>z
Time passes.

"I told you now didn't I tell you?" old Abbot Gubbler is saying, plaintively. "Here? Why here? You shouldn't have come here."

The Figure says something in reply. I can only hear two words, but they're enough to stop my heart. "Failure," and "Consequences."

* * *

>z
Time passes.

"But these things, these things are not always tick-tock, they never are," the old man replies. His voice is quivering, quite different from the steady drone he has when intoning in Chapel. "The - item you asked about - it's in the Vaults, you see? The Vaults. Even if I could get in, I …"

The Figure is too far from the keyhole and speaks too quietly for me to hear clearly. "Disappointing," he says; and then "unslip your gears."

>z
Time passes.

The Abbot is spluttering and choking. I've seen him like this only once, when as a young initiate I dropped and smashed an altimeter right before the Archbishop was due to visit.

The Figure's quiet voice continues. I can make out; "too old to steal", "a better mechanism", "the opportunity."

The Abbot nods violently, shaking out agreement the way I might beat dirt from a duster. "My money?" he asks.

>z
Time passes.

There's the clink, of a pouch of golden minutes. A heavy pouch. The Figure, paying the Abbot…? Then suddenly, there's a third voice. "Sorry, Father, to interrupt, but you said…"

It's a monk of the Abbey. "Get out!" the Abbot screeches. His bearing's lost its oil, it seems. "Get out, get out!"

"But Father," the monk continues, "it's time, you know. You told me to tell you when it was time."

"Oh! Of course of course," he mumbles. "I'll… We'll continue this discussion later, then," he says, to the Figure.

The Figure intones something in reply.

The Abbot leaves, and that leaves me alone, inside this clock, with the stranger outside. He's coming nearer… I can hear his fingers on the door of the case! I must have nudged the penduluum, he must have seen the clock-hands quiver… but then, there's the swish of his cloak as he moves away, and the click as the door closes. Phew.

>z
Time passes.

>out
I spill gratefully out of the clock, gasping for breath as though I've been underwater. I've just been holding it in, of course. As what I've heard - well, I probably shouldn't have, and the quicker I can get out of here, the better.

Abbot's Quarters
I need to get out of this place as fast as I can and without attracting any more  attention. The door to the hallway is back east and as for polishing the  Grandfather clock - well, forget it!

St. Newton is staring at the Abbot's unpolished Grandfather clock with a severe frown.

>w
I'm going to have to tell someone what I just heard. A theft, from the Vaults! But if the Abbot's involved - then who else might be? After all, the figure he was talking to could have been anyone in the Abbey!

Corridor of Contemplation
The ancient stones of the Abbey rise to about shoulder-height before arching over, forcing me to bow my head in supplication before the Abbot's door, back east. To the west, I can hear the gentle echo of ticks and tocks coming from the Abbey's main hall.

Carved into the walls are a series of pious engravings, depicting the long path from initiate to Abbot.

* * *

>e
Kitchen
If there was ever a proof of the perfection of Clockwork over Nature, it's that the dirtiest and most hectic room in the whole Abbey is its Kitchen. Shelves, walls and floor are covered by machines belching, slicing, steaming, chopping, stirring, boiling, broiling, frying, pureeing … the list goes on. The noise, smell and heat is almost overpowering, and the Cook, who controls this madhouse, can only stand it because he's stone deaf.

I can escape back into the cool of the Hall to the west. South, through a broad arch, is the Refectory.

>s
East Refectory
The eastern end of the long Refectory is given over in part to the tables lined with brass hourglasses, but in the other half there's nothing but the enormous Refectory Clock. It's an impressive thing, so big because it only needs winding once a year, despite all the gongs, cymbals, tubes and bells that strike when dinner time comes around. Right now, the clock is showing the time at just after quarter past three.

Pungent smells drift in from the kitchen to the north. On the east wall is the small green door to the Abbey's herb garden.

>z
Time passes.

>z
Time passes.

Distantly - but not distantly enough - I can hear the clock and clatter of Drake's boots. The sound's coming from the west.

>w
I catch the sound of hobnailed boots. Drake's heading this way! I'd better wait, and let him pass.

I've got a moment before Drake spots me: he's just appeared, to the west.

>w
I walk right into Drake - no time to run away.
"Wren!" Drake exclaims. He wallops me on the arm. "I thought I told you to stay in your room?" He doesn't wait for an excuse before I'm dragged off to the ladder. Then he waits - and wallops me - until I give in and climb all the way back up.

Attic Room
Back in the attic. The Cathedral is still just as far away, visible through the  hole in the ceiling above my cot. But the ladder's the only way out of here.

That was careless, getting caught. But I can still make it to the Cathedral. I'll just have to be more cunning this time. Remember, Wren, it's easy: the whole world runs on clockwork. Just a matter of staying ahead of the biting teeth.

* * *

>w
I'm not staying here. I walk straight out again… but Drake's waiting to push me back.

"Polish the clock, loose-screw!" he clangs. "And don't come out till it's shining!"

"Yeah," Calvin says. "It's got to look as good as if we did it!"

"Idiot," Drake mutters. "Come on."

Their voices disappear down the hall.

>polish clock
I whisper the correct mantra against the evils of Friction and Dust, and start polishing. This'll take forever!

The grandfather clock ticks off a minute with a stately thunk. Quickly, I make the sign of the winding gear.

>x clock
No wonder Calvin and Drake didn't want to do this. Abbot Gubbler's Grandfather clock is enormous: the face is the size of a dinnerplate and the cabinet below is big enough to be a wardrobe. Even just polishing the doors will take half an hour. The whole thing might take all day.

From the hallway outside comes the echo of voices. Too shaky to be Calvin or Drake. More like - oh, no. It's the Abbot, coming back to his room. And if he finds me here, then my springs won't be worth the spindles they're sprung to…

>open clock door
I open the clock door and peek inside. For a big clock it's got a pretty small penduluum, about the size of Calvin's fist and not as big as Drake's. There's even enough space in front of it for the Abbot to hang up one of his spare robes.

The Abbot's voice is getting closer. The old man may move slower than a short hand, but he's definitely coming this way.

>enter clock
"We'll talk in here," I hear the Abbot saying, from right outside the door. "More private. More quiet. Much better." The old man steps inside the room, followed by a tall figure in grey. In the last tick before his old eyes can see me, I dive inside the gigantic clock case and pull closed the door.

Inside Clock Case
As the phrase goes, I'm stuck between a rack and a gear-trace; except here I'm in the narrow gap between the clock case door and the heavy swinging penduluum behind. And if that hit me, and disrupted the holy timings… well, there's no way they wouldn't notice when the clock-hands stopped moving, let's just say.

A little light shines in through the keyhole, which is almost covered by the Abbott's spare robe.

Oh, no… That click outside was the sound of the Abbot closing the door. Looks like he - and the grey figure I glimpsed with him - are going to be here for a while…

* * *

>polish clock
I whisper the correct mantra against the evils of Friction and Dust, and start polishing. This'll take forever!

From the hallway outside comes the echo of voices. Too shaky to be Calvin or Drake. More like - oh, no. It's the Abbot, coming back to his room. And if he finds me here, then my springs won't be worth the spindles they're sprung to…

>listen
I hear nothing unexpected.

The Abbot's voice is getting closer. The old man may move slower than a short hand, but he's definitely coming this way.

>listen to abbot
I can't see any such thing.

>listen
I hear nothing unexpected.

Oh, widdershins! Gubbler is right outside the door! I'd better hide!

>w
The Abbot's voice is getting nearer… If he sees I've been in here, he'll have me turning the paddles in the laundry room for a month! There's nothing for it, I'll have to escape.

"We'll talk in here," I hear the Abbot saying, from right outside the door. "More private. More quiet. Much better." The old man steps inside the room, followed by a tall figure in grey. In the last tick before his old eyes can see me, I dive inside the gigantic clock case and pull closed the door.

Inside Clock Case
As the phrase goes, I'm stuck between a rack and a gear-trace; except here I'm in the narrow gap between the clock case door and the heavy swinging penduluum behind. And if that hit me, and disrupted the holy timings… well, there's no way they wouldn't notice when the clock-hands stopped moving, let's just say.

A little light shines in through the keyhole, which is almost covered by the Abbot's spare robe.

Oh, no… That click outside was the sound of the Abbot closing the door. Looks like he - and the grey figure I glimpsed with him - are going to be here for a while…

>undo
Abbot's Quarters
[Previous turn undone.]

>polish clock
If you think the Abbot will come in here, and say, "Oh, good, young Wren's polishing my clock," then you must have come unsprung. If he finds me here doing Calvin and Drakes work he'll have me declared unmechanistical and maybe even throw me out of the Abbey!

"We'll talk in here," I hear the Abbot saying, from right outside the door. "More private. More quiet. Much better." The old man steps inside the room, followed by a tall figure in grey. In the last tick before his old eyes can see me, I dive inside the gigantic clock case and pull closed the door.

Inside Clock Case
As the phrase goes, I'm stuck between a rack and a gear-trace; except here I'm in the narrow gap between the clock case door and the heavy swinging penduluum behind. And if that hit me, and disrupted the holy timings… well, there's no way they wouldn't notice when the clock-hands stopped moving, let's just say.

A little light shines in through the keyhole, which is almost covered by the Abbot's spare robe.

Oh, no… That click outside was the sound of the Abbot closing the door. Looks like he - and the grey figure I glimpsed with him - are going to be here for a while…

>x figure
The glimpse I caught earlier was a tall - man? - wearing a suit of grey leather and a long flowing cape. Now I can't see him at all - it's almost as though he knows I'm hiding, and he's avoiding the keyhole's line of sight.

"I told you now didn't I tell you?" old Abbot Gubbler is saying, plaintively. "Here? Why here? You shouldn't have come here."

The Figure says something in reply. I can only hear two words, but they're enough to stop my heart. "Failure," and "Consequences."

>open door
I open Gubbler's Grandfather clock.

"But these things, these things are not always tick-tock, they never are," the old man replies. His voice is quivering, quite different from the steady drone he has when intoning in Chapel. "The - item you asked about - it's in the Vaults, you see? The Vaults. Even if I could get in, I …"

The Figure is too far from the keyhole and speaks too quietly for me to hear clearly. "Disappointing," he says; and then "unslip your gears."

>undo
Inside Clock Case
[Previous turn undone.]

* * *

>polish clock
If you think the Abbot will come in here, and say, "Oh, good, young Wren's polishing my clock," then you must have come unsprung. If he finds me here doing Calvin and Drakes work he'll have me declared unmechanistical and maybe even throw me out of the Abbey!

The Abbot's voice is getting closer. The old man may move slower than a short hand, but he's definitely coming this way.

>hide
What do I want to hide under?

>clock
I find nothing of interest.

Oh, widdershins! Gubbler is right outside the door! I'd better hide!

>hide under cot
I find nothing of interest.

The space under the cot is too small for me! Somewhere else, and quick!

"We'll talk in here," I hear the Abbot saying, from right outside the door. "More private. More quiet. Much better." The old man steps inside the room, followed by a tall figure in grey. In the last tick before his old eyes can see me, I dive inside the gigantic clock case and pull closed the door.

Inside Clock Case
As the phrase goes, I'm stuck between a rack and a gear-trace; except here I'm in the narrow gap between the clock case door and the heavy swinging penduluum behind. And if that hit me, and disrupted the holy timings… well, there's no way they wouldn't notice when the clock-hands stopped moving, let's just say.

A little light shines in through the keyhole, which is almost covered by the Abbot's spare robe.

Oh, no… That click outside was the sound of the Abbot closing the door. Looks like he - and the grey figure I glimpsed with him - are going to be here for a while…

>listen with tumbler
Oh… well, then. I tip out the last of the polish onto the floor of the clock. At least that part will shine.

I put the glass tumbler carefully against the door, then lean down to press my ear against it. Fantastic! I can hear much more clearly now!

"I told you now didn't I tell you?" old Abbot Gubbler is saying, plaintively. "Here? Why here? You shouldn't have come here."

The Figure says something in reply. With the glass, I can hear quite clearly. That was a good idea. "We have been disappointed with your failure. The cause and effect principle, Abbot. Such failure must bring consequences."

>look through keyhole
I can make out the Abbot's hands, which are shaking badly. But I can see nothing of the Figure.

"But these things, these things are not always tick-tock, they never are," the old man replies. His voice is quivering, quite different from the steady drone he has when intoning in Chapel. "The - item you asked about - it's in the Vaults, you see? The Vaults. Even if I could get in, I …"

"Your excuses we find disappointing. Very disappointing. More of this and, Abbot, we may need to unslip your gears completely."

>x abbot
I can't see much through the keyhole, except the Abbot's stout waist and shaking hands. Not much good for winding anything now, but if I said as much to anyone then I'd be in real trouble.

The Abbot is spluttering and choking. You've seen him like this only once, when as a young initiate you dropped and smashed an altimeter right before the Archbishop was due to visit.

The Figure continues. "Clearly you're too old to steal the item for us. We have a better mechanism for obtaining it. But you must provide us with the opportunity. Is that understood?"

The Abbot nods violently, shaking out agreement the way I might beat dirt from a duster. "My money?" he asks.

>x hands
I can't see much through the keyhole, except the Abbot's stout waist and shaking hands. Not much good for winding anything now, but if I said as much to anyone then I'd be in real trouble.

There's the clink, of a pouch of golden minutes. A heavy pouch. The Figure, paying the Abbot…? Then suddenly, there's a third voice. "Sorry, Father, to interrupt, but you said…"

It's a monk of the Abbey. "Get out!" the Abbot screeches. His bearing's lost its oil, it seems. "Get out, get out!"

"But Father," the monk continues, "it's time, you know. You told me to tell you when it was time."

"Oh! Of course of course," he mumbles. "I'll… We'll continue this discussion later, then," he says, to the Figure.

"We certainly will," the Figure replies.

The Abbot leaves, and that leaves me alone, inside this clock, with the stranger outside. He's coming nearer… I can hear his fingers on the door of the case! I must have nudged the penduluum, he must have seen the clock-hands quiver… but then, there's the swish of his cloak as he moves away, and the click as the door closes. Phew.

>out
I spill gratefully out of the clock, gasping for breath as though I've been underwater. I've just been holding it in, of course. As what I've heard - well, I probably shouldn't have, and the quicker I can get out of here, the better.

Abbot's Quarters
If I thought Abbots lived in luxury, then I was dead wrong. Even my attic's cosier than this. The Abbot's got no furniture at all, except a desk and a cot, and no decoration except for a bust of St. Newton. None of the axle-mounted bevelled mobiles I was expecting. There's barely even any sunlight: one thin window to catch the sun-rise, opposite the door to the hallway back west.

St. Newton is staring at the Abbot's unpolished Grandfather clock with a severe frown.

* * *

>e
No fear. I'm not going back in there.

>close door
I close the Abbot's Door.

>e
(first opening the Abbot's Door)
No fear. I'm not going back in there.

>close door
I close the Abbot's Door.

>w
I dart of the tunnel, only to be stopped dead by a depressing sight. It's Calvin and Drake, hurrying in through the Abbey's Great Entry. Their mouths are white with sugar.

"Hey, you!" Drake shouts. In a moment he's got me by the ear. "What were you doing in the Abbot's room? That's not on your rota!"

"Yeah!" Calvin adds. "And why are you slipping away when we told you to be there?"

"Idiot," Drake hisses. Louder - for the benefit of any passing monks - he says, "That's it, Wren. You're consigned to your room." For good measure, he punches me on the arm, then the two of them drag me away, heels over flagstones, right to the bottom of the ladder.

"Up you go," Calvin says. "And you're not to come down till dark!"

"What about dinner?" I ask.

"Should have thought of that, shouldn't you?" Drake says.

"More for us," Calvin adds. "Only two hours to go. I'm starved."

With that, they punch me again, and wait until I scurry away up the ladder.

Attic Room
This isn't really an attic. It isn't really a room either. It's a couple of floorboards laid across some roof rafters right in the ceiling of the Abbey. There's enough floor-space for a cot and a laundry crate, but I have to be careful not to roll out of bed, because if I do, the thick cobwebs all around aren't going to stop me from falling….

A little hole in the ceiling provides some sunlight: and when it rains, it means I can wash my hair, too. It's right above the rickety ladder down to the ground (and that means the ladder is starting to rot and bend).

I can see a picture here.

Through my window I can see the Cathedral across the yard outside. If I was a bird, I could escape easily, and tell someone what I've overheard. The Abbot's about to do something terrible and I've got to stop him! Someone at the Cathedral would listen: the Archbishop himself, perhaps. He might remember me from the time he visited, when he helped me repair an altimeter I'd broken. If only I could fly.

But perhaps I can escape on foot. If I'm clever. Clockwise.

>d
I scramble quickly down the ladder.

Rickety Stair
I'm in one corner of the Great Hall, just by the foot of the ladder up to my room. There's a note attached to it, asking Amble the caretaker not to put it back in the shed just yet.

>x note
"Please leave. Needed for initiate until a cell is freed up by older brother. - Gubbler."

>x stair
I can't see any such thing.

>e
Upper Hall
The Great Hall of the Abbey is the biggest room I've seen in my life, running from this end all the way southwest (and it is all the way, I'm never allowed further) to the Great Doors and the Yard outside. If I crane my neck I can see the dark square of the floorboards of my room - the ladder is on one side, to the west. Lights moves in and out overhead, from the candles moving on their Holy Tracks. Strong smells float through an archway to the east.

From their niches, the Three Major Saints are watching sternly, keen that I should get out of the Cathedral and talk to the Archbishop as quickly as possible.

>x sw
I see nothing unexpected in that direction.

>x ladder
I can't see any such thing.

>sw
Just in time, I see Drake's there. I hang back, to let him move on.

>sw
Center Hall
I'm standing in the very centre of the Abbey's Great Hall. It's impossible not to crane my neck here, to gaze up at the ceiling held aloft by buttresses like gigantic oak trees. To think, people built this in the days before proper pulley-transmissions! It must have taken weeks! The hall continues northeast into shadow, and southwest, towards the sunlight, the Yard and above all, the Archbishop.

The vast empty space is filled by the muttering and echo of Holy Mechanisms, and the hiss of the candles as they sweep around their Tracks, providing a little light everywhere but rarely ever enough. I can just make out archways both east and west.

>w
Library
The Abbey's library is small compared to the one in the Cathedral. There's nothing on the shelves but the key texts: the Principia, the Mechanistica and the Determininium. Only Brother Horloge, the Abbey's Primary Reader ever seems to use them - he's here at the moment, studying at his desk by the poor light coming through the stained glass windows. By his elbow is a fat bunch of keys. On his shoulder is his mechanical owl, wings folded.

An archway leads east back into the hall. From the southwest comes the clatter of Writing hammers and the sharp smell of burnt ink.

>x horloge
Horloge's eyes are screwed up behind the most complicated pair of spectacles I've ever encountered. They make it hard to even see his eyes - or rather what's left of them. He's read in the darkness here in the Library for so long he's basically blind. On his shoulder sits his pet owl. Same as Brother Horloge it looks more fearsome than it actually is.

By his elbow is a fat bunch of keys.

>get keys
Brother Horloge puts out a worn-out old hand. "Now don't you wander off with my keys," he says. "They're very important."

>x table
The table is set on little brass castors to allow Brother Horloge to follow the feeble patch of sunlight around the room.

Distantly - but not distantly enough - I can hear the clock and clatter of Drake's boots. The sound's coming from the southwest.

>e
Center Hall
I'm standing in the very centre of the Abbey's Great Hall. It's impossible not to crane my neck here, to gaze up at the ceiling held aloft by buttresses like gigantic oak trees. To think, people built this in the days before proper pulley-transmissions! It must have taken weeks! The hall continues northeast into shadow, and southwest, towards the sunlight, the Yard and above all, the Archbishop.

The vast empty space is filled by the muttering and echo of Holy Mechanisms, and the hiss of the candles as they sweep around their Tracks, providing a little light everywhere but rarely ever enough. I can just make out archways both east and west.

Drake's on patrol, and I can hear him heading this way, from the west.

>sw
Lower Hall
Looking northeast, the Great Hall of the Abbey stretches away like the belly of some big beast, its bony roof held up by pillars like swallowed trees. The walls are carelessly lit by candles moving through Sacred Tracks suspended in the air. I can just make out the Corridor of Contemplation to the east, and the wider archway to the Scriptorium to the west.

But more importantly, the great Entry - and exit - of the Abbey is to the southwest. And if I'm going to get out of here and talk to the Archbishop that's the only way to go.

But maybe you're starting to see what kind of luck I have. Right there, in the Entry, is Calvin, working on a clock.

>ne
I catch the sound of hobnailed boots. Drake's heading this way! I'd better wait, and let him pass.

>ne
Just in time, I see Drake's there. I hang back, to let him move on.

>ne
Center Hall
I'm standing in the very centre of the Abbey's Great Hall. It's impossible not to crane my neck here, to gaze up at the ceiling held aloft by buttresses like gigantic oak trees. To think, people built this in the days before proper pulley-transmissions! It must have taken weeks! The hall continues northeast into shadow, and southwest, towards the sunlight, the Yard and above all, the Archbishop.

The vast empty space is filled by the muttering and echo of Holy Mechanisms, and the hiss of the candles as they sweep around their Tracks, providing a little light everywhere but rarely ever enough. I can just make out archways both east and west.

>w
Library
The Abbey's library is small compared to the one in the Cathedral. There's nothing on the shelves but the key texts: the Principia, the Mechanistica and the Determininium. Only Brother Horloge, the Abbey's Primary Reader ever seems to use them - he's here at the moment, studying at his desk by the poor light coming through the stained glass windows. By his elbow is a fat bunch of keys. On his shoulder is his mechanical owl, wings folded.

An archway leads east back into the hall. From the southwest comes the clatter of Writing hammers and the sharp smell of burnt ink.

>x keys
A thick bunch of keys, to most of the Abbey's locks and clocks alike.

* * *

>w
I'm not staying here. I walk straight out again… but Drake's waiting to push me back.

"Polish the clock, loose-screw!" he clangs. "And don't come out till it's shining!"

"Yeah," Calvin says. "It's got to look as good as if we did it!"

"Idiot," Drake mutters. "Come on."

Their voices disappear down the hall.

>enter clock
I should polish the outside of the clock first, and that'll probably take more than long enough.

The grandfather clock ticks off a minute with a stately thunk. Quickly, I make the sign of the winding gear.

>w
Curses to counterweights! It's not on my rota, this clock, so why should I finish off my polish on it? I head for the doorway - then freeze. Voices, coming down the hall. It's the Abbot himself, coming this way!

* * *

>w
I catch the sound of hobnailed boots. Drake's heading this way! I'd better wait, and let him pass.

>w
Just in time, I see Drake's there. I hang back, to let him move on.

* * *

>z
Time passes.

>e
I catch the sound of hobnailed boots. Drake's heading this way! I'd better wait, and let him pass.

>z
Time passes.

Distantly - but not distantly enough - I can hear the clock and clatter of Drake's boots. The sounds coming from the southwest.

>e
Center Hall
I'm standing in the very centre of the Abbey's Great Hall. It's impossible not to crane my neck here, to gaze up at the ceiling held aloft by buttresses like gigantic oak trees. To think, people built this in the days before proper pulley-transmissions! It must have taken weeks! The hall continues northeast into shadow, and southwest, towards the sunlight, the Yard and above all, the Archbishop.

The vast empty space is filled by the muttering and echo of Holy Mechanisms, and the hiss of the candles as they sweep around their Tracks, providing a little light everywhere but rarely ever enough. I can just make out archways both east and west.

Drake's footsteps echo in from the west.

>z
Time passes.

I've got a moment before Drake spots me: he's just appeared, to the west.

>z
Time passes.

"Wren!" Drake exclaims. He wallops me on the arm. "I thought I told you to stay in your room?" He doesn't wait for an excuse before I'm dragged off to the ladder. Then he waits - and wallops me - until I give in and climb all the way back up.

Attic Room
This isn't really an attic. It isn't really a room either. It's a couple of floorboards laid across some roof rafters right in the ceiling of the Abbey. There's enough floor-space for a cot and a laundry crate, but I have to be careful not to roll out of bed, because if I do, the thick cobwebs all around aren't going to stop me from falling….

A little hole in the ceiling provides some sunlight: and when it rains, it means I can wash my hair, too. It's right above the rickety ladder down to the ground (and that means the ladder is starting to rot and bend).

That was careless, getting caught. But I can still make it to the Cathedral. I'll just have to be more cunning this time. Remember, Wren, it's easy: the whole world runs on clockwork. Just a matter of staying ahead of the biting teeth.

>d
I scramble quickly down the ladder.

Rickety Stair
I'm in one corner of the Great Hall, just by the foot of the ladder up to my room. There's a note attached to it, asking Amble the caretaker not to put it back in the shed just yet.

>e
Upper Hall
The Great Hall of the Abbey is the biggest room I've seen in my life, running from this end all the way southwest (and it is all the way, I'm never allowed further) to the Great Doors and the Yard outside. If I crane my neck I can see the dark square of the floorboards of my room - the ladder is on one side, to the west. Lights moves in and out overhead, from the candles moving on their Holy Tracks. Strong smells float through an archway to the east.

From their niches, the Three Major Saints are watching sternly, keen that I should get out of the Cathedral and talk to the Archbishop as quickly as possible.

Drake's clattering boots are audible to the east.

>sw
Center Hall
I'm standing in the very centre of the Abbey's Great Hall. It's impossible not to crane my neck here, to gaze up at the ceiling held aloft by buttresses like gigantic oak trees. To think, people built this in the days before proper pulley-transmissions! It must have taken weeks! The hall continues northeast into shadow, and southwest, towards the sunlight, the Yard and above all, the Archbishop.

The vast empty space is filled by the muttering and echo of Holy Mechanisms, and the hiss of the candles as they sweep around their Tracks, providing a little light everywhere but rarely ever enough. I can just make out archways both east and west.

Drake's footsteps echo in from the northeast.

>ne
I catch the sound of hobnailed boots. Drake's heading this way! I'd better wait, and let him pass.

Looking northeast, I can see Drake. He's coming this way!

>ne
Just in time, I see Drake's there. I hang back, to let him move on.

Drake looks like he's swallowed a bee. Not only have I disobeyed him, but I've done it twice. "I'm going to have your skin," he hisses into in my ear. "I'm going to use it as a cloak comes winter. Understand?" With that he drags me back off to my attic. This time, I can barely climb the stairs.

Attic Room
This isn't really an attic. It isn't really a room either. It's a couple of floorboards laid across some roof rafters right in the ceiling of the Abbey. There's enough floor-space for a cot and a laundry crate, but I have to be careful not to roll out of bed, because if I do, the thick cobwebs all around aren't going to stop me from falling….

A little hole in the ceiling provides some sunlight: and when it rains, it means I can wash my hair, too. It's right above the rickety ladder down to the ground (and that means the ladder is starting to rot and bend).

A quick pause for breath and… right then. I'm ready. I'm going to get out of the Abbey somehow, and warn the Archbishop. And I won't give up till I've got there!

>d
I scramble quickly down the ladder.

Rickety Stair
I'm in one corner of the Great Hall, just by the foot of the ladder up to my room. There's a note attached to it, asking Amble the caretaker not to put it back in the shed just yet.

* * *

>sw
Center Hall
I'm standing in the very centre of the Abbey's Great Hall. It's impossible not to crane my neck here, to gaze up at the ceiling held aloft by buttresses like gigantic oak trees. To think, people built this in the days before proper pulley-transmissions! It must have taken weeks! The hall continues northeast into shadow, and southwest, towards the sunlight, the Yard and above all, the Archbishop.

The vast empty space is filled by the muttering and echo of Holy Mechanisms, and the hiss of the candles as they sweep around their Tracks, providing a little light everywhere but rarely ever enough. I can just make out archways both east and west.

I've got a moment before Drake spots me: he's just appeared, to the west.

>sw
Lower Hall
Looking northeast, the Great Hall of the Abbey stretches away like the belly of some big beast, its bony roof held up by pillars like swallowed trees. The walls are carelessly lit by candles moving through Sacred Tracks suspended in the air. I can just make out the Corridor of Contemplation to the east, and the wider archway to the Scriptorium to the west.

But more importantly, the great Entry - and exit - of the Abbey is to the southwest. And if I'm going to get out of here and talk to the Archbishop that's the only way to go.

But maybe you're starting to see what kind of luck I have. Right there, in the Entry, is Calvin, working on a clock.

* * *

>ne
Library
The Abbey's library is small compared to the one in the Cathedral. There's nothing on the shelves but the key texts: the Principia, the Mechanistica and the Determininium. Only Brother Horloge, the Abbey's Primary Reader ever seems to use them - he's here at the moment, studying at his desk by the poor light coming through the stained glass windows. By his elbow is a fat bunch of keys. On his shoulder is his mechanical owl, wings folded.

An archway leads east back into the hall. From the southwest comes the clatter of Writing hammers and the sharp smell of burnt ink.

>e
Center Hall
I'm standing in the very centre of the Abbey's Great Hall. It's impossible not to crane my neck here, to gaze up at the ceiling held aloft by buttresses like gigantic oak trees. To think, people built this in the days before proper pulley-transmissions! It must have taken weeks! The hall continues northeast into shadow, and southwest, towards the sunlight, the Yard and above all, the Archbishop.

The vast empty space is filled by the muttering and echo of Holy Mechanisms, and the hiss of the candles as they sweep around their Tracks, providing a little light everywhere but rarely ever enough. I can just make out archways both east and west.

Drake's on patrol, and I can hear him heading this way, from the northeast.

>e
West Refectory
I spend some of my time here, eating at one of the two long tables. I spend even more serving the monks. Each of them has their own seat, marked by a little brass hourglass, and if the twenty or so I can see here weren't enough (which they aren't), there's more to the east, where the Refectory continues. Back west is the archway to the Great Hall.

On the table is a single empty teacup, left over from breakfast.

>e
East Refectory
The eastern end of the long Refectory is given over in part to the tables lined with brass hourglasses, but in the other half there's nothing but the enormous Refectory Clock. It's an impressive thing, so big because it only needs winding once a year, despite all the gongs, cymbals, tubes and bells that strike when dinner time comes around. Right now, the clock is showing the time at just after 3pm.

Pungent smells drift in from the kitchen to the north. On the east wall is the small green door to the Abbey's herb garden.

* * *

>w
I catch the sound of hobnailed boots. Drake's heading this way! I'd better wait, and let him pass.

>z
Time passes.

>w
I dart of the tunnel, only to be stopped dead by a depressing sight. It's Calvin and Drake, hurrying in through the Abbey's Great Entry. Their mouths are white with sugar.

"Hey, you!" Drake shouts. In a moment he's got me by the ear. "What were you doing in the Abbot's room? That's not on your rota!"

"Yeah!" Calvin adds. "And why are you slipping away when we told you to be there?"

"Idiot," Drake hisses. Louder - for the benefit of any passing monks - he says, "That's it, Wren. You're consigned to your room." For good measure, he punches me on the arm, then the two of them drag me away, heels over flagstones, right to the bottom of the ladder.

"Up you go," Calvin says. "And you're not to come down till dark!"

"What about dinner?" I ask.

"Should have thought of that, shouldn't you?" Drake says.

"More for us," Calvin adds. "Only two hours to go. I'm starved."

With that, they punch me again, and wait until I scurry away up the ladder.

Attic Room
This isn't really an attic. It isn't really a room either. It's a couple of floorboards laid across some roof rafters right in the ceiling of the Abbey. There's enough floor-space for a cot and a laundry crate, but I have to be careful not to roll out of bed, because if I do, the thick cobwebs all around aren't going to stop me from falling….

A little hole in the ceiling provides some sunlight: and when it rains, it means I can wash my hair, too. It's right above the rickety ladder down to the ground (and that means the ladder is starting to rot and bend).

Through my window I can see the Cathedral across the yard outside. If I was a bird, I could escape easily, and tell someone what I've overheard. The Abbot's about to do something terrible and I've got to stop him! Someone at the Cathedral would listen: the Archbishop himself, perhaps. He might remember me from the time he visited, when he helped me repair an altimeter I'd broken. If only I could fly.

But perhaps I can escape on foot. If I'm clever. Clockwise.

* * *

>d
I scramble quickly down the ladder.

Rickety Stair
I'm in one corner of the Great Hall, just by the foot of the ladder up to my room. There's a note attached to it, asking Amble the caretaker not to put it back in the shed just yet.

>u
I scramble up the ladder. It's a long way, and pretty exhausting.

Attic Room
This isn't really an attic. It isn't really a room either. It's a couple of floorboards laid across some roof rafters right in the ceiling of the Abbey. There's enough floor-space for a cot and a laundry crate, but I have to be careful not to roll out of bed, because if I do, the thick cobwebs all around aren't going to stop me from falling….

A little hole in the ceiling provides some sunlight: and when it rains, it means I can wash my hair, too. It's right above the rickety ladder down to the ground (and that means the ladder is starting to rot and bend).

>z
Time passes.

>d
I scramble quickly down the ladder.

Rickety Stair
I'm in one corner of the Great Hall, just by the foot of the ladder up to my room. There's a note attached to it, asking Amble the caretaker not to put it back in the shed just yet.

>e
Upper Hall
The Great Hall of the Abbey is the biggest room I've seen in my life, running from this end all the way southwest (and it is all the way, I'm never allowed further) to the Great Doors and the Yard outside. If I crane my neck I can see the dark square of the floorboards of my room - the ladder is on one side, to the west. Lights moves in and out overhead, from the candles moving on their Holy Tracks. Strong smells float through an archway to the east.

From their niches, the Three Major Saints are watching sternly, keen that I should get out of the Cathedral and talk to the Archbishop as quickly as possible.

Drake's clattering boots are audible to the southwest.

>e
Kitchen
If there was ever a proof of the perfection of Clockwork over Nature, it's that the dirtiest and most hectic room in the whole Abbey is its Kitchen. Shelves, walls and floor are covered by machines belching, slicing, steaming, chopping, stirring, boiling, broiling, frying, pureeing … the list goes on. The noise, smell and heat is almost overpowering, and the Cook, who controls this madhouse, can only stand it because he's stone deaf.

Drake's footsteps echo in from the west.

>s
East Refectory
The eastern end of the long Refectory is given over in part to the tables lined with brass hourglasses, but in the other half there's nothing but the enormous Refectory Clock. It's an impressive thing, so big because it only needs winding once a year, despite all the gongs, cymbals, tubes and bells that strike when dinner time comes around. Right now, the clock is showing the time at just after 3pm.

Pungent smells drift in from the kitchen to the north. On the east wall is the small green door to the Abbey's herb garden.

Looking west, I can see Drake. He's coming this way!

>n
Kitchen
If there was ever a proof of the perfection of Clockwork over Nature, it's that the dirtiest and most hectic room in the whole Abbey is its Kitchen. Shelves, walls and floor are covered by machines belching, slicing, steaming, chopping, stirring, boiling, broiling, frying, pureeing … the list goes on. The noise, smell and heat is almost overpowering, and the Cook, who controls this madhouse, can only stand it because he's stone deaf.

I've got a moment before Drake spots me: he's just appeared, to the south.

>w
Upper Hall
The Great Hall of the Abbey is the biggest room I've seen in my life, running from this end all the way southwest (and it is all the way, I'm never allowed further) to the Great Doors and the Yard outside. If I crane my neck I can see the dark square of the floorboards of my room - the ladder is on one side, to the west. Lights moves in and out overhead, from the candles moving on their Holy Tracks. Strong smells float through an archway to the east.

From their niches, the Three Major Saints are watching sternly, keen that I should get out of the Cathedral and talk to the Archbishop as quickly as possible.

Looking east, I can see Drake. He's coming this way!

>sw
Center Hall
I'm standing in the very centre of the Abbey's Great Hall. It's impossible not to crane my neck here, to gaze up at the ceiling held aloft by buttresses like gigantic oak trees. To think, people built this in the days before proper pulley-transmissions! It must have taken weeks! The hall continues northeast into shadow, and southwest, towards the sunlight, the Yard and above all, the Archbishop.

The vast empty space is filled by the muttering and echo of Holy Mechanisms, and the hiss of the candles as they sweep around their Tracks, providing a little light everywhere but rarely ever enough. I can just make out archways both east and west.

Drake's just off to the northeast, and he's coming this way!

>e
West Refectory
I spend some of my time here, eating at one of the two long tables. I spend even more serving the monks. Each of them has their own seat, marked by a little brass hourglass, and if the twenty or so I can see here weren't enough (which they aren't), there's more to the east, where the Refectory continues. Back west is the archway to the Great Hall.

On the table is a single empty teacup, left over from breakfast.

Looking west, I can see Drake. He's coming this way!

>z
Time passes.

Drake's on patrol, and I can hear him heading this way, from the west.

>l
West Refectory
I spend some of my time here, eating at one of the two long tables. I spend even more serving the monks. Each of them has their own seat, marked by a little brass hourglass, and if the twenty or so I can see here weren't enough (which they aren't), there's more to the east, where the Refectory continues. Back west is the archway to the Great Hall.

On the table is a single empty teacup, left over from breakfast.

>w
Center Hall
I'm standing in the very centre of the Abbey's Great Hall. It's impossible not to crane my neck here, to gaze up at the ceiling held aloft by buttresses like gigantic oak trees. To think, people built this in the days before proper pulley-transmissions! It must have taken weeks! The hall continues northeast into shadow, and southwest, towards the sunlight, the Yard and above all, the Archbishop.

The vast empty space is filled by the muttering and echo of Holy Mechanisms, and the hiss of the candles as they sweep around their Tracks, providing a little light everywhere but rarely ever enough. I can just make out archways both east and west.

Drake's just off to the west, and he's coming this way!

>sw
Lower Hall
Looking northeast, the Great Hall of the Abbey stretches away like the belly of some big beast, its bony roof held up by pillars like swallowed trees. The walls are carelessly lit by candles moving through Sacred Tracks suspended in the air. I can just make out the Corridor of Contemplation to the east, and the wider archway to the Scriptorium to the west.

But more importantly, the great Entry - and exit - of the Abbey is to the southwest. And if I'm going to get out of here and talk to the Archbishop that's the only way to go.

But maybe you're starting to see what kind of luck I have. Right there, in the Entry, is Calvin, working on a clock.

Looking northeast, I can see Drake. He's coming this way!

>w
Scriptorium
The Scriptorium is where the Copying takes place, though it's hard to believe that Copying once meant a team of monks working with carved rubber stamps. It's all done by mechanisms now, of course, like everything else except my chores. There's the massive Gutenberg press on the west wall, and everywhere else is Brother Reloh's Duplicator. Twenty-three Typewriters, all clattering away as though operated by ghosts, all connected by a single Carriage Arm that curves the length of the wall. To leave the room east or northeast I'll have to duck under.

Reloh works on one of the keyboards of the Duplicator, typing furiously. The hammering and punching is almost overwhelming.

The Gutenberg seems to be in the midst of a repair. The Cabinet of Relics next to it is open.

>e
Lower Hall
Looking northeast, the Great Hall of the Abbey stretches away like the belly of some big beast, its bony roof held up by pillars like swallowed trees. The walls are carelessly lit by candles moving through Sacred Tracks suspended in the air. I can just make out the Corridor of Contemplation to the east, and the wider archway to the Scriptorium to the west.

But more importantly, the great Entry - and exit - of the Abbey is to the southwest. And if I'm going to get out of here and talk to the Archbishop that's the only way to go.

But maybe you're starting to see what kind of luck I have. Right there, in the Entry, is Calvin, working on a clock.

>ne
Center Hall
I'm standing in the very centre of the Abbey's Great Hall. It's impossible not to crane my neck here, to gaze up at the ceiling held aloft by buttresses like gigantic oak trees. To think, people built this in the days before proper pulley-transmissions! It must have taken weeks! The hall continues northeast into shadow, and southwest, towards the sunlight, the Yard and above all, the Archbishop.

The vast empty space is filled by the muttering and echo of Holy Mechanisms, and the hiss of the candles as they sweep around their Tracks, providing a little light everywhere but rarely ever enough. I can just make out archways both east and west.

Drake's clattering boots are audible to the northeast.

>e
West Refectory
I spend some of my time here, eating at one of the two long tables. I spend even more serving the monks. Each of them has their own seat, marked by a little brass hourglass, and if the twenty or so I can see here weren't enough (which they aren't), there's more to the east, where the Refectory continues. Back west is the archway to the Great Hall.

On the table is a single empty teacup, left over from breakfast.

Drake's footsteps echo in from the west.

>z
Time passes.

Drake's just off to the west, and he's coming this way!

>z
Time passes.

Drake's clattering boots are audible to the west.

* * *

>z
Time passes.

Distantly - but not distantly enough - I can hear the clock and clatter of Drake's boots. The sounds coming from the northeast.

>w
Library
The Abbey's library is small compared to the one in the Cathedral. There's nothing on the shelves but the key texts: the Principia, the Mechanistica and the Determininium. Only Brother Horloge, the Abbey's Primary Reader ever seems to use them - he's here at the moment, studying at his desk by the poor light coming through the stained glass windows. By his elbow is a fat bunch of keys. On his shoulder is his mechanical owl, wings folded.

An archway leads east back into the hall. From the southwest comes the clatter of Writing hammers and the sharp smell of burnt ink.

* * *

>z
Time passes.

>z
Time passes.

Drake's clattering boots are audible to the southwest.

>e
Center Hall
I'm standing in the very centre of the Abbey's Great Hall. It's impossible not to crane my neck here, to gaze up at the ceiling held aloft by buttresses like gigantic oak trees. To think, people built this in the days before proper pulley-transmissions! It must have taken weeks! The hall continues northeast into shadow, and southwest, towards the sunlight, the Yard and above all, the Archbishop.

The vast empty space is filled by the muttering and echo of Holy Mechanisms, and the hiss of the candles as they sweep around their Tracks, providing a little light everywhere but rarely ever enough. I can just make out archways both east and west.

Drake's footsteps echo in from the west.

>sw
Lower Hall
Looking northeast, the Great Hall of the Abbey stretches away like the belly of some big beast, its bony roof held up by pillars like swallowed trees. The walls are carelessly lit by candles moving through Sacred Tracks suspended in the air. I can just make out the Corridor of Contemplation to the east, and the wider archway to the Scriptorium to the west.

But more importantly, the great Entry - and exit - of the Abbey is to the southwest. And if I'm going to get out of here and talk to the Archbishop that's the only way to go.

But maybe you're starting to see what kind of luck I have. Right there, in the Entry, is Calvin, working on a clock.

>z
Time passes.

>z
Time passes.

Drake's clattering boots are audible to the northeast.

>ne
I catch the sound of hobnailed boots. Drake's heading this way! I'd better wait, and let him pass.

Looking northeast, I can see Drake. He's coming this way!

>w
Scriptorium
The Scriptorium is where the Copying takes place, though it's hard to believe that Copying once meant a team of monks working with carved rubber stamps. It's all done by mechanisms now, of course, like everything else except my chores. There's the massive Gutenberg press on the west wall, and everywhere else is Brother Reloh's Duplicator. Twenty-three Typewriters, all clattering away as though operated by ghosts, all connected by a single Carriage Arm that curves the length of the wall. To leave the room east or northeast I'll have to duck under.

Reloh works on one of the keyboards of the Duplicator, typing furiously. The hammering and punching is almost overwhelming.

The Gutenberg seems to be in the midst of a repair. The Cabinet of Relics next to it is open.

Drake's just off to the east, and he's coming this way!

>ne
Library
The Abbey's library is small compared to the one in the Cathedral. There's nothing on the shelves but the key texts: the Principia, the Mechanistica and the Determininium. Only Brother Horloge, the Abbey's Primary Reader ever seems to use them - he's here at the moment, studying at his desk by the poor light coming through the stained glass windows. By his elbow is a fat bunch of keys. On his shoulder is his mechanical owl, wings folded.

An archway leads east back into the hall. From the southwest comes the clatter of Writing hammers and the sharp smell of burnt ink.

I've got a moment before Drake spots me: he's just appeared, to the southwest.

>e
Center Hall
I'm standing in the very centre of the Abbey's Great Hall. It's impossible not to crane my neck here, to gaze up at the ceiling held aloft by buttresses like gigantic oak trees. To think, people built this in the days before proper pulley-transmissions! It must have taken weeks! The hall continues northeast into shadow, and southwest, towards the sunlight, the Yard and above all, the Archbishop.

The vast empty space is filled by the muttering and echo of Holy Mechanisms, and the hiss of the candles as they sweep around their Tracks, providing a little light everywhere but rarely ever enough. I can just make out archways both east and west.

Looking west, I can see Drake. He's coming this way!

>sw
Lower Hall
Looking northeast, the Great Hall of the Abbey stretches away like the belly of some big beast, its bony roof held up by pillars like swallowed trees. The walls are carelessly lit by candles moving through Sacred Tracks suspended in the air. I can just make out the Corridor of Contemplation to the east, and the wider archway to the Scriptorium to the west.

But more importantly, the great Entry - and exit - of the Abbey is to the southwest. And if I'm going to get out of here and talk to the Archbishop that's the only way to go.

But maybe you're starting to see what kind of luck I have. Right there, in the Entry, is Calvin, working on a clock.

>ne
Just in time, I see Drake's there. I hang back, to let him move on.

* * *

>e
West Refectory
I spend some of my time here, eating at one of the two long tables. I spend even more serving the monks. Each of them has their own seat, marked by a little brass hourglass, and if the twenty or so I can see here weren't enough (which they aren't), there's more to the east, where the Refectory continues. Back west is the archway to the Great Hall.

On the table is a single empty teacup, left over from breakfast.

>get cup
I can't see any such thing.

>z
Time passes.

>w
Center Hall
I'm standing in the very centre of the Abbey's Great Hall. It's impossible not to crane my neck here, to gaze up at the ceiling held aloft by buttresses like gigantic oak trees. To think, people built this in the days before proper pulley-transmissions! It must have taken weeks! The hall continues northeast into shadow, and southwest, towards the sunlight, the Yard and above all, the Archbishop.

The vast empty space is filled by the muttering and echo of Holy Mechanisms, and the hiss of the candles as they sweep around their Tracks, providing a little light everywhere but rarely ever enough. I can just make out archways both east and west.

I've got a moment before Drake spots me: he's just appeared, to the west.

>w
Just in time, I see Drake's there. I hang back, to let him move on.

"Wren!" Drake exclaims. He wallops me on the arm. "I thought I told you to stay in your room?" He doesn't wait for an excuse before I'm dragged off to the ladder. Then he waits - and wallops me - until I give in and climb all the way back up.

Attic Room
This isn't really an attic. It isn't really a room either. It's a couple of floorboards laid across some roof rafters right in the ceiling of the Abbey. There's enough floor-space for a cot and a laundry crate, but I have to be careful not to roll out of bed, because if I do, the thick cobwebs all around aren't going to stop me from falling….

A little hole in the ceiling provides some sunlight: and when it rains, it means I can wash my hair, too. It's right above the rickety ladder down to the ground (and that means the ladder is starting to rot and bend).

That was careless, getting caught. But I can still make it to the Cathedral. I'll just have to be more cunning this time. Remember, Wren, it's easy: the whole world runs on clockwork. Just a matter of staying ahead of the biting teeth.

>undo
Center Hall
[Previous turn undone.]

>undo
West Refectory
[Previous turn undone.]

>z
Time passes.

Drake's footsteps echo in from the west.

>w
I catch the sound of hobnailed boots. Drake's heading this way! I'd better wait, and let him pass.

Drake's just off to the west, and he's coming this way!

* * *

>enter clock
I should polish the outside of the clock first, and that'll probably take more than long enough.

The grandfather clock ticks off a minute with a stately thunk. Quickly, I make the sign of the winding gear.

>listen with tumblert
I can't see any such thing.

>listen with tumbler
I hear nothing unexpected.

From the hallway outside comes the echo of voices. Too shaky to be Calvin or Drake. More like - oh, no. It's the Abbot, coming back to his room. And if he finds me here, then my springs won't be worth the spindles they're sprung to…

>enter clock
"We'll talk in here," I hear the Abbot saying, from right outside the door. "More private. More quiet. Much better." The old man steps inside the room, followed by a tall figure in grey. In the last tick before his old eyes can see me, I dive inside the gigantic clock case and pull closed the door.

Inside Clock Case
As the phrase goes, I'm stuck between a rack and a gear-trace; except here I'm in the narrow gap between the clock case door and the heavy swinging penduluum behind. And if that hit me, and disrupted the holy timings… well, there's no way they wouldn't notice when the clock-hands stopped moving, let's just say.

A little light shines in through the keyhole, which is almost covered by the Abbot's spare robe.

Oh, no… That click outside was the sound of the Abbot closing the door. Looks like he - and the grey figure I glimpsed with him - are going to be here for a while…

* * *

>s
I can't go that way.

>undo
Upper Hall
[Previous turn undone.]

>sw
Central Hall
I'm standing in the very centre of the Abbey's Great Hall. It's impossible not to crane my neck here, to gaze up at the ceiling held aloft by buttresses like gigantic oak trees. To think, people built this in the days before proper pulley-transmissions! It must have taken weeks! The hall continues northeast into shadow, and southwest, towards the sunlight, the Yard and above all, the Archbishop.

The vast empty space is filled by the muttering and echo of Holy Mechanisms, and the hiss of the candles as they sweep around their Tracks, providing a little light everywhere but rarely ever enough. I can just make out archways both east and west.

I've got a moment before Drake spots me: he's just appeared, to the west.

>sw
Lower Hall
Looking northeast, the Great Hall of the Abbey stretches away like the belly of some big beast, its bony roof held up by pillars like swallowed trees. The walls are carelessly lit by candles moving through Sacred Tracks suspended in the air. I can just make out the Corridor of Contemplation to the east, and the wider archway to the Scriptorium to the west.

But more importantly, the great Entry - and exit - of the Abbey is to the southwest. And if I'm going to get out of here and talk to the Archbishop that's the only way to go.

But maybe you're starting to see what kind of luck I have. Right there, in the Entry, is Calvin, working on a clock.

* * *

>z
Time passes.

>ne
Central Hall
I'm standing in the very centre of the Abbey's Great Hall. It's impossible not to crane my neck here, to gaze up at the ceiling held aloft by buttresses like gigantic oak trees. To think, people built this in the days before proper pulley-transmissions! It must have taken weeks! The hall continues northeast into shadow, and southwest, towards the sunlight, the Yard and above all, the Archbishop.

The vast empty space is filled by the muttering and echo of Holy Mechanisms, and the hiss of the candles as they sweep around their Tracks, providing a little light everywhere but rarely ever enough. I can just make out archways both east and west.

>e
West Refectory
I spend some of my time here, eating at one of the two long tables. I spend even more serving the monks. Each of them has their own seat, marked by a little brass hourglass, and if the twenty or so I can see here weren't enough (which they aren't), there's more to the east, where the Refectory continues. Back west is the archway to the Great Hall.

On the table is a single empty teacup, left over from breakfast.

* * *

>get cup
I pick up the empty cup from its place beside by Brother Horloge's hourglass.

>w
I catch the sound of hobnailed boots. Drake's heading this way! I'd better wait, and let him pass.

* * *

>z
Time passes.

>w
Central Hall
I'm standing in the very centre of the Abbey's Great Hall. It's impossible not to crane my neck here, to gaze up at the ceiling held aloft by buttresses like gigantic oak trees. To think, people built this in the days before proper pulley-transmissions! It must have taken weeks! The hall continues northeast into shadow, and southwest, towards the sunlight, the Yard and above all, the Archbishop.

The vast empty space is filled by the muttering and echo of Holy Mechanisms, and the hiss of the candles as they sweep around their Tracks, providing a little light everywhere but rarely ever enough. I can just make out archways both east and west.

Looking west, I can see Drake. He's coming this way!

>sw
Lower Hall
Looking northeast, the Great Hall of the Abbey stretches away like the belly of some big beast, its bony roof held up by pillars like swallowed trees. The walls are carelessly lit by candles moving through Sacred Tracks suspended in the air. I can just make out the Corridor of Contemplation to the east, and the wider archway to the Scriptorium to the west.

But more importantly, the great Entry - and exit - of the Abbey is to the southwest. And if I'm going to get out of here and talk to the Archbishop that's the only way to go.

But maybe you're starting to see what kind of luck I have. Right there, in the Entry, is Calvin, working on a clock.

* * *

>ne
Library
The Abbey's library is small compared to the one in the Cathedral. There's nothing on the shelves but the key texts: the Principia, the Mechanistica and the Determininium. Only Brother Horloge, the Abbey's Primary Reader ever seems to use them - he's here at the moment, studying at his desk by the poor light coming through the stained glass windows. By his elbow is a fat bunch of keys. On his shoulder is his mechanical owl, wings folded.

An archway leads east back into the hall. From the southwest comes the clatter of Writing hammers and the sharp smell of burnt ink.

Horloge looks up as I enter. "Ah, young - young Whotsit!" he bellows, pointing a fat finger in my general direction, though through his thick multi-lensed spectacles I don't think he can quite see where I am. "Look here!" he demands. "Young Whotsit-whoever-you-are! I need some - some of that, you know. Some of that whotsit. A good… of whotsit? Uh-huh? Good? Good." He smiles, then looks back down to his studies, muttering.

>e
Central Hall
I'm standing in the very centre of the Abbey's Great Hall. It's impossible not to crane my neck here, to gaze up at the ceiling held aloft by buttresses like gigantic oak trees. To think, people built this in the days before proper pulley-transmissions! It must have taken weeks! The hall continues northeast into shadow, and southwest, towards the sunlight, the Yard and above all, the Archbishop.

The vast empty space is filled by the muttering and echo of Holy Mechanisms, and the hiss of the candles as they sweep around their Tracks, providing a little light everywhere but rarely ever enough. I can just make out archways both east and west.

Distantly - but not distantly enough - I can hear the clock and clatter of Drake's boots. The sound's coming from the northeast.

>ne
I catch the sound of hobnailed boots. Drake's heading this way! I'd better wait, and let him pass.

I've got a moment before Drake spots me: he's just appeared, to the northeast.

>e
West Refectory
I spend some of my time here, eating at one of the two long tables. I spend even more serving the monks. Each of them has their own seat, marked by a little brass hourglass, and if the twenty or so I can see here weren't enough (which they aren't), there's more to the east, where the Refectory continues. Back west is the archway to the Great Hall.

>z
Time passes.

>w
Central Hall
I'm standing in the very centre of the Abbey's Great Hall. It's impossible not to crane my neck here, to gaze up at the ceiling held aloft by buttresses like gigantic oak trees. To think, people built this in the days before proper pulley-transmissions! It must have taken weeks! The hall continues northeast into shadow, and southwest, towards the sunlight, the Yard and above all, the Archbishop.

The vast empty space is filled by the muttering and echo of Holy Mechanisms, and the hiss of the candles as they sweep around their Tracks, providing a little light everywhere but rarely ever enough. I can just make out archways both east and west.

Drake's footsteps echo in from the west.

>ne
Upper Hall
The Great Hall of the Abbey is the biggest room I've seen in my life, running from this end all the way southwest (and it is all the way, I'm never allowed further) to the Great Doors and the Yard outside. If I crane my neck I can see the dark square of the floorboards of my room - the ladder is on one side, to the west. Lights move in and out overhead, from the candles moving on their Holy Tracks. Strong smells float through an archway to the east.

From their niches, the Three Major Saints are watching sternly, keen that I should get out of the Cathedral and talk to the Archbishop as quickly as possible.

>e
Kitchen
If there was ever a proof of the perfection of Clockwork over Nature, it's that the dirtiest and most hectic room in the whole Abbey is its Kitchen. Shelves, walls and floor are covered by machines belching, slicing, steaming, chopping, stirring, boiling, broiling, frying, pureeing … the list goes on. The noise, smell and heat is almost overpowering, and the Cook, who controls this madhouse, can only stand it because he's stone deaf.

In one corner is the only machine I'm allowed to use: the Tea Maker. There's a jar of tea leaf beside it. 

I can escape back into the cool of the Hall to the west. South, through a broad arch, is the Refectory.

The cook scurries past me, to thump the masher.

>put tea leaves in tea machine
(the tea leaves in the Tea Machine)
(first taking some tea from the jar)
The basket's now filled with tea leaves.

Drake's clattering boots are audible to the south.

>undo
Kitchen
[Previous turn undone.]

>put tea leaves in basket
(the tea leaves in the basket)
(first taking some tea from the jar)
The basket's now filled with tea leaves.

Drake's clattering boots are audible to the south.

>turn spigot
The spigot releases a thin dribble of water into the kettle. Across the room, the clouds coming from the steamer suddenly thin out and the Cook pauses to give me the most evil of evil stars. I turn the spigot closed again.

Drake's just off to the south, and he's coming this way!

>w
Upper Hall
The Great Hall of the Abbey is the biggest room I've seen in my life, running from this end all the way southwest (and it is all the way, I'm never allowed further) to the Great Doors and the Yard outside. If I crane my neck I can see the dark square of the floorboards of my room - the ladder is on one side, to the west. Lights move in and out overhead, from the candles moving on their Holy Tracks. Strong smells float through an archway to the east.

From their niches, the Three Major Saints are watching sternly, keen that I should get out of the Cathedral and talk to the Archbishop as quickly as possible.

Looking east, I can see Drake. He's coming this way!

* * *

>w
Rickety Stair
I'm in one corner of the Great Hall, just by the foot of the ladder up to my room. There's a note attached to it, asking Amble the caretaker not to put it back in the shed just yet.

I beg your pardon?

>z
Time passes.

* * *

>x gears
(the machines)
Pipes run like cobwebs between a hundred fantastic devices. One entire corner is given over to automatic egg-boiling: "A Holy Problem of Timing," Gubbler once said. Other wires, pulleys, ducts, gears and cog-teeth cross the floor and ceiling, and the Cook is constantly sweeping muck and crumbs out from the mechanisms in a desperate attempt to keep them in good order.

The cook pushes past me, to respring the steamer.

>get gear
Which do I mean, the gear train or the small gear?

>small
While the Cook is distracted - the Cook is always distracted - I pluck the out the worn down gear. Not the sort of repair a clock polisher should be doing!

>put cup in bracket
Done.

Drake's on patrol, and I can hear him heading this way, from the south.

>sw
I can't go that way.

The cook knocks past me, to unclip the oven.

Drake's just off to the south, and he's coming this way!

>undo
Kitchen
[Previous turn undone.]

>w
Upper Hall
The Great Hall of the Abbey is the biggest room I've seen in my life, running from this end all the way southwest (and it is all the way, I'm never allowed further) to the Great Doors and the Yard outside. If I crane my neck I can see the dark square of the floorboards of my room - the ladder is on one side, to the west. Lights move in and out overhead, from the candles moving on their Holy Tracks. Strong smells float through an archway to the east.

From their niches, the Three Major Saints are watching sternly, keen that I should get out of the Cathedral and talk to the Archbishop as quickly as possible.

Drake's footsteps echo in from the east.

>sw
Central Hall
I'm standing in the very centre of the Abbey's Great Hall. It's impossible not to crane my neck here, to gaze up at the ceiling held aloft by buttresses like gigantic oak trees. To think, people built this in the days before proper pulley-transmissions! It must have taken weeks! The hall continues northeast into shadow, and southwest, towards the sunlight, the Yard and above all, the Archbishop.

The vast empty space is filled by the muttering and echo of Holy Mechanisms, and the hiss of the candles as they sweep around their Tracks, providing a little light everywhere but rarely ever enough. I can just make out archways both east and west.

Drake's clattering boots are audible to the northeast.

>sw
Lower Hall
Looking northeast, the Great Hall of the Abbey stretches away like the belly of some big beast, its bony roof held up by pillars like swallowed trees. The walls are carelessly lit by candles moving through Sacred Tracks suspended in the air. I can just make out the Corridor of Contemplation to the east, and the wider archway to the Scriptorium to the west.

But more importantly, the great Entry - and exit - of the Abbey is to the southwest. And if I'm going to get out of here and talk to the Archbishop that's the only way to go.

But maybe you're starting to see what kind of luck I have. Right there, in the Entry, is Calvin, working on a clock.

Drake's footsteps echo in from the northeast.

>w
Scriptorium
The Scriptorium is where the Copying takes place, though it's hard to believe that Copying once meant a team of monks working with carved rubber stamps. It's all done by mechanisms now, of course, like everything else except my chores. There's the massive Gutenberg press on the west wall, and everywhere else is Brother Reloh's Duplicator. Twenty-three Typewriters, all clattering away as though operated by ghosts, all connected by a single Carriage Arm that curves the length of the wall. To leave the room east or northeast I'll have to duck under.

Reloh works on one of the keyboards of the Duplicator, typing furiously. The hammering and punching is almost overwhelming.

The Gutenberg seems to be in the midst of a repair. The Cabinet of Relics next to it is open.

Drake's clattering boots are audible to the east.

>get new gear
"Put that back," Reloh snaps, without looking up. But I don't put it back.

Drake's just off to the east, and he's coming this way!

>n
I can't go that way.

"Wren!" Drake exclaims. He wallops me on the arm. "I thought I told you to stay in your room?" He doesn't wait for an excuse before I'm dragged off to the ladder. Then he waits - and wallops me - until I give in and climb all the way back up.

Attic Room
This isn't really an attic. It isn't really a room either. It's a couple of floorboards laid across some roof rafters right in the ceiling of the Abbey. There's enough floor-space for a cot and a laundry crate, but I have to be careful not to roll out of bed, because if I do, the thick cobwebs all around aren't going to stop me from falling….

A little hole in the ceiling provides some sunlight: and when it rains, it means I can wash my hair, too. It's right above the rickety ladder down to the ground (and that means the ladder is starting to rot and bend).

That was careless, getting caught. But I can still make it to the Cathedral. I'll just have to be more cunning this time. Remember, Wren, it's easy: the whole world runs on clockwork. Just a matter of staying ahead of the biting teeth.

>undo
Scriptorium
[Previous turn undone.]

>ne
Library
The Abbey's library is small compared to the one in the Cathedral. There's nothing on the shelves but the key texts: the Principia, the Mechanistica and the Determininium. Only Brother Horloge, the Abbey's Primary Reader ever seems to use them - he's here at the moment, studying at his desk by the poor light coming through the stained glass windows. By his elbow is a fat bunch of keys. On his shoulder is his mechanical owl, wings folded.

An archway leads east back into the hall. From the southwest comes the clatter of Writing hammers and the sharp smell of burnt ink.

I've got a moment before Drake spots me: he's just appeared, to the southwest.

>e
Central Hall
I'm standing in the very centre of the Abbey's Great Hall. It's impossible not to crane my neck here, to gaze up at the ceiling held aloft by buttresses like gigantic oak trees. To think, people built this in the days before proper pulley-transmissions! It must have taken weeks! The hall continues northeast into shadow, and southwest, towards the sunlight, the Yard and above all, the Archbishop.

The vast empty space is filled by the muttering and echo of Holy Mechanisms, and the hiss of the candles as they sweep around their Tracks, providing a little light everywhere but rarely ever enough. I can just make out archways both east and west.

Looking west, I can see Drake. He's coming this way!

>ne
Upper Hall
The Great Hall of the Abbey is the biggest room I've seen in my life, running from this end all the way southwest (and it is all the way, I'm never allowed further) to the Great Doors and the Yard outside. If I crane my neck I can see the dark square of the floorboards of my room - the ladder is on one side, to the west. Lights move in and out overhead, from the candles moving on their Holy Tracks. Strong smells float through an archway to the east.

From their niches, the Three Major Saints are watching sternly, keen that I should get out of the Cathedral and talk to the Archbishop as quickly as possible.

>e
Kitchen
If there was ever a proof of the perfection of Clockwork over Nature, it's that the dirtiest and most hectic room in the whole Abbey is its Kitchen. Shelves, walls and floor are covered by machines belching, slicing, steaming, chopping, stirring, boiling, broiling, frying, pureeing … the list goes on. The noise, smell and heat is almost overpowering, and the Cook, who controls this madhouse, can only stand it because he's stone deaf.

In one corner is the only machine I'm allowed to use: the Tea Maker. There's a jar of tea leaf beside it. In the bracket of the machine is a teacup. 

I can escape back into the cool of the Hall to the west. South, through a broad arch, is the Refectory.

The cook knocks past me, to thump the oven.

Drake's on patrol, and I can hear him heading this way, from the south.

>put new gear in machine
(the Tea Machine)
The gear train forms a perfect snake from the lever, over the semi-circular bracket and into the innards of the machine.

Drake's just off to the south, and he's coming this way!

>w
Upper Hall
The Great Hall of the Abbey is the biggest room I've seen in my life, running from this end all the way southwest (and it is all the way, I'm never allowed further) to the Great Doors and the Yard outside. If I crane my neck I can see the dark square of the floorboards of my room - the ladder is on one side, to the west. Lights move in and out overhead, from the candles moving on their Holy Tracks. Strong smells float through an archway to the east.

From their niches, the Three Major Saints are watching sternly, keen that I should get out of the Cathedral and talk to the Archbishop as quickly as possible.

Looking east, I can see Drake. He's coming this way!

* * *

>e
Kitchen
If there was ever a proof of the perfection of Clockwork over Nature, it's that the dirtiest and most hectic room in the whole Abbey is its Kitchen. Shelves, walls and floor are covered by machines belching, slicing, steaming, chopping, stirring, boiling, broiling, frying, pureeing … the list goes on. The noise, smell and heat is almost overpowering, and the Cook, who controls this madhouse, can only stand it because he's stone deaf.

In one corner is the only machine I'm allowed to use: the Tea Maker. There's a jar of tea leaf beside it. In the bracket of the machine is a teacup. 

I can escape back into the cool of the Hall to the west. South, through a broad arch, is the Refectory.

>pull lever
The lever moves without resistance. It's been long enough since breakfast, clearly, that the spring has wound down.

The cook scurries past me, to wind the broiler.

>undo
Kitchen
[Previous turn undone.]

>turn key
(the tea machine key)
A few turns and the spring is fully wound.

>pull lever
The gear train whirrs into life, swinging the kettle across inside the machine. Its base knocks open the gas-pipe tap. A jet of gas hisses out, blowing up a tiny sail attached by thread to the flint-iron. The burner is quickly alight.

>z
Time passes.

After a minute or so, steam begins to rise from the kettle. This steam collects on a fine gauze over the kettle, which slowly weighs down on a thin metal strut. Eventually, the pressure is enough to flip a counterweight, and the gauze tilts, pushes the kettle onto its side. Boiling water pours from the spout and into the basket of tea leaves. As the kettle empties, its weight shifts and it swings back. A pin on one side knocks closed the gas pipe.

The cook pushes past me, to respring the whisker.

Drake's clattering boots are audible to the south.

>z
Time passes.

The basket slows filters tea into the waiting cup. Meanwhile, the slowing gears move the kettle back to its original position below the spigot, and the water on the gauze sheet evaporates away. All is restored: "Every cog comes full circle," as they say.

Drake's just off to the south, and he's coming this way!

>z
Time passes.

The lever springs back. The tea is finished. In a final convulsion, the machine spits the used tea leaves out the back and into a composter duct, ready to be fed to the cows that provided the gas… It's certainly neat.

"Wren!" Drake exclaims. He wallops me on the arm. "I thought I told you to stay in your room?" He doesn't wait for an excuse before I'm dragged off to the ladder. Then he waits - and wallops me - until I give in and climb all the way back up.

Attic Room
This isn't really an attic. It isn't really a room either. It's a couple of floorboards laid across some roof rafters right in the ceiling of the Abbey. There's enough floor-space for a cot and a laundry crate, but I have to be careful not to roll out of bed, because if I do, the thick cobwebs all around aren't going to stop me from falling….

A little hole in the ceiling provides some sunlight: and when it rains, it means I can wash my hair, too. It's right above the rickety ladder down to the ground (and that means the ladder is starting to rot and bend).

That was careless, getting caught. But I can still make it to the Cathedral. I'll just have to be more cunning this time. Remember, Wren, it's easy: the whole world runs on clockwork. Just a matter of staying ahead of the biting teeth.

>d
I scramble quickly down the ladder.

Rickety Stair
I'm in one corner of the Great Hall, just by the foot of the ladder up to my room. There's a note attached to it, asking Amble the caretaker not to put it back in the shed just yet.

>e
Just in time, I see Drake's there. I hang back, to let him move on.

* * *

>e
Kitchen
If there was ever a proof of the perfection of Clockwork over Nature, it's that the dirtiest and most hectic room in the whole Abbey is its Kitchen. Shelves, walls and floor are covered by machines belching, slicing, steaming, chopping, stirring, boiling, broiling, frying, pureeing … the list goes on. The noise, smell and heat is almost overpowering, and the Cook, who controls this madhouse, can only stand it because he's stone deaf.

In one corner is the only machine I'm allowed to use: the Tea Maker. There's a jar of tea leaf beside it. In the bracket of the machine is a steaming cup of tea. 

I can escape back into the cool of the Hall to the west. South, through a broad arch, is the Refectory.

>get cup
I lift the cup carefully from the machine. The Cook turns and for the first time seems to notice me. He looks furious. "And where you thin' you go wi' tha'?" he demands. "Wait. Wa'."

After a bit of tidying, he finds a button to press. A machine coughs and wheezes, and eventually a small half-slice of lemon squeezes from a slot. The Cook snatches it and drops it into my tea cup. "Ri' you are," he says, and then waves me away.

>w
Upper Hall
The Great Hall of the Abbey is the biggest room I've seen in my life, running from this end all the way southwest (and it is all the way, I'm never allowed further) to the Great Doors and the Yard outside. If I crane my neck I can see the dark square of the floorboards of my room - the ladder is on one side, to the west. Lights move in and out overhead, from the candles moving on their Holy Tracks. Strong smells float through an archway to the east.

From their niches, the Three Major Saints are watching sternly, keen that I should get out of the Cathedral and talk to the Archbishop as quickly as possible.

* * *

>w
Library
The Abbey's library is small compared to the one in the Cathedral. There's nothing on the shelves but the key texts: the Principia, the Mechanistica and the Determininium. Only Brother Horloge, the Abbey's Primary Reader ever seems to use them - he's here at the moment, studying at his desk by the poor light coming through the stained glass windows. By his elbow is a fat bunch of keys. On his shoulder is his mechanical owl, wings folded.

An archway leads east back into the hall. From the southwest comes the clatter of Writing hammers and the sharp smell of burnt ink.

>give tea to horloge
I set the cup down beside Brother Horloge's elbow. "Excellent, there," he says, beaming, nostrils twitching. "Such a smell! The finest!" He lifts the cup, takes a sip and smacks his lips. "It's the slight metallic tang that really gives it the whotsit," he adds. His eyes half-close in calm delight.

>get keys
His eyes are only half-closed. They're half-open as well. He bats my hand away firmly. "Leave them be," he says. Of course, he knocks them to the floor in the process and he doesn't notice that.

>get keys
Very quietly, I pick the keys up off the ground. With his eyes half-shut, Horloge doesn't notice.

Drake's on patrol, and I can hear him heading this way, from the southwest.

>e
Central Hall
I'm standing in the very centre of the Abbey's Great Hall. It's impossible not to crane my neck here, to gaze up at the ceiling held aloft by buttresses like gigantic oak trees. To think, people built this in the days before proper pulley-transmissions! It must have taken weeks! The hall continues northeast into shadow, and southwest, towards the sunlight, the Yard and above all, the Archbishop.

The vast empty space is filled by the muttering and echo of Holy Mechanisms, and the hiss of the candles as they sweep around their Tracks, providing a little light everywhere but rarely ever enough. I can just make out archways both east and west.

Drake's clattering boots are audible to the west.

>ne
Upper Hall
The Great Hall of the Abbey is the biggest room I've seen in my life, running from this end all the way southwest (and it is all the way, I'm never allowed further) to the Great Doors and the Yard outside. If I crane my neck I can see the dark square of the floorboards of my room - the ladder is on one side, to the west. Lights move in and out overhead, from the candles moving on their Holy Tracks. Strong smells float through an archway to the east.

From their niches, the Three Major Saints are watching sternly, keen that I should get out of the Cathedral and talk to the Archbishop as quickly as possible.

>e
Kitchen
If there was ever a proof of the perfection of Clockwork over Nature, it's that the dirtiest and most hectic room in the whole Abbey is its Kitchen. Shelves, walls and floor are covered by machines belching, slicing, steaming, chopping, stirring, boiling, broiling, frying, pureeing … the list goes on. The noise, smell and heat is almost overpowering, and the Cook, who controls this madhouse, can only stand it because he's stone deaf.

I can escape back into the cool of the Hall to the west. South, through a broad arch, is the Refectory.

>w
Upper Hall
The Great Hall of the Abbey is the biggest room I've seen in my life, running from this end all the way southwest (and it is all the way, I'm never allowed further) to the Great Doors and the Yard outside. If I crane my neck I can see the dark square of the floorboards of my room - the ladder is on one side, to the west. Lights move in and out overhead, from the candles moving on their Holy Tracks. Strong smells float through an archway to the east.

From their niches, the Three Major Saints are watching sternly, keen that I should get out of the Cathedral and talk to the Archbishop as quickly as possible.

* * *

>e
West Refectory
I spend some of my time here, eating at one of the two long tables. I spend even more serving the monks. Each of them has their own seat, marked by a little brass hourglass, and if the twenty or so I can see here weren't enough (which they aren't), there's more to the east, where the Refectory continues. Back west is the archway to the Great Hall.

>e
East Refectory
The eastern end of the long Refectory is given over in part to the tables lined with brass hourglasses, but in the other half there's nothing but the enormous Refectory Clock. It's an impressive thing, so big because it only needs winding once a year, despite all the gongs, cymbals, tubes and bells that strike when dinner time comes around. Right now, the clock is showing the time at just after twenty past four.

Pungent smells drift in from the kitchen to the north. On the east wall is the small green door to the Abbey's herb garden.

>unlock clock
(with Horloge's Keys)
I unlock the Refectory Clock.

* * *

>e
East Refectory
The eastern end of the long Refectory is given over in part to the tables lined with brass hourglasses, but in the other half there's nothing but the enormous Refectory Clock. It's an impressive thing, so big because it only needs winding once a year, despite all the gongs, cymbals, tubes and bells that strike when dinner time comes around. Right now, the clock is showing the time at just after twenty past four.

Pungent smells drift in from the kitchen to the north. On the east wall is the small green door to the Abbey's herb garden.

>set clock to 9:45
Resetting a clock is heresy of a pretty high order: but even if the situation is desperate enough to require it, the case is still locked.

>unlock clock
(with Horloge's Keys)
I unlock the Refectory Clock.

>set clock to 6:00
Putting a clock wrong turns my stomach… but the thought of that Figure in Grey spurs me on. So I make the sign of the Winding Key - maybe that'll buy me some forgiveness when I wind down. Then I push the hands round to six o'clock.

>set clock to 5:00
It's horrible to be making a habit of this. Flinching, I push the hands round to five o'clock.

The clash of metal on metal: the Refectory Clock leaps into life like an advancing army, its bells, gongs and organ pipes ringing and chiming and clanging away! Very, very quickly, I slam shut the clock case door and, covering my ears, rush over to the other side of the room. It's still horribly loud.

>W
West Refectory
I spend some of my time here, eating at one of the two long tables. I spend even more serving the monks. Each of them has their own seat, marked by a little brass hourglass, and if the twenty or so I can see here weren't enough (which they aren't), there's more to the east, where the Refectory continues. Back west is the archway to the Great Hall.

Gongs, bells and all manner of noises are echoing around the walls.

Calvin and Drake explode into the room and barge me out of the way as they race over to the East Refectory.

>x calvin
Calvin and Drake are too busy to pay any notice of me now.

Calvin and Drake race over to the clock and start struggling with the case. Both are hampered by keeping their hands over both their ears at the same time.

>undo
West Refectory
[Previous turn undone.]

>undo
East Refectory
[Previous turn undone.]

>z
Time passes.

Calvin and Drake have raced into the West Refectory. "Wren?" Drake shouts. "Turn that thing off! It's not dinner yet!"

I put one hand to my ear, as if I couldn't hear him at all.

>z
Time passes.

Calvin and Drake race over to the clock and start struggling with the case. Both are hampered by keeping their hands over both their ears at the same time.

I slip away quietly into the Kitchen.

Kitchen
If there was ever a proof of the perfection of Clockwork over Nature, it's that the dirtiest and most hectic room in the whole Abbey is its Kitchen. Shelves, walls and floor are covered by machines belching, slicing, steaming, chopping, stirring, boiling, broiling, frying, pureeing … the list goes on. The noise, smell and heat is almost overpowering, and the Cook, who controls this madhouse, can only stand it because he's stone deaf.

I can escape back into the cool of the Hall to the west. South, through a broad arch, is the Refectory, where the Refectory Clock is throwing up a wall of sound.

The cook knocks past me, to tighten the oven.

* * *

>W
I'm not staying here. I walk straight out again… but Drake's waiting to push me back.

"Polish the clock, loose-screw!" he clangs. "And don't come out till it's shining!"

"Yeah," Calvin says. "It's got to look as good as if we did it!"

"Idiot," Drake mutters. "Come on."

Their voices disappear down the hall.

>w
Corridor of Contemplation C2
The grandfather clock ticks off a minute with a stately thunk. Quickly, I make the sign of the winding gear.

>undo
Abbot's Quarters
[Previous turn undone.]

* * *

>rub rag
That seems clean enough as it is.

"And don't come out till that clock's shining!" shouts Drake from the hall.

"Yeah," Calvin says. "It's got to look as good as if we did it!"

"Idiot," Drake mutters. "Come on."

Their voices disappear down the hall.

>s
You can't go that way.

The grandfather clock ticks off a minute with a stately thunk. Quickly, I make the sign of the winding gear.

>e
You can't go that way.

From the hallway outside comes the echo of voices. Too shaky to be Calvin or Drake. More like - oh, no. It's the Abbot, coming back to his room. And if he finds me here, then my springs won't be worth the spindles they're sprung to…

>in
You can't go that way.

The Abbot's voice is getting closer. The old man may move slower than a short hand, but he's definitely coming this way.

>open clock
I open the clock door and peek inside.

For a big clock it's got a pretty small penduluum, about the size of Calvin's fist and not as big as Drake's. There's enough even space in front of it for the Abbot to hang up one of his spare robes.

Oh, widdershins! Gubbler is right outside the door! I'd better hide!

* * *

>open clock
I open the clock door and peek inside. For a big clock it's got a pretty small penduluum, about the size of Calvin's fist and not as big as Drake's. There's even enough space in front of it for the Abbot to hang up one of his spare robes.

"And don't come out till that clock's shining!" shouts Drake from the hall.

"Yeah," Calvin says. "It's got to look as good as if we did it!"

"Idiot," Drake mutters. "Come on."

Their voices disappear down the hall.

>enter clock
You get into Abbot Gubbler's Grandfather clock.

In Abbot Gubbler's Grandfather clock you can see a robe, a penduluum and two counterweights.

The grandfather clock ticks off a minute with a stately thunk. Quickly, I make the sign of the winding gear.

>close clock
You close Abbot Gubbler's Grandfather clock.

From the hallway outside comes the echo of voices. Too shaky to be Calvin or Drake. More like - oh, no. It's the Abbot, coming back to his room. And if he finds me here, then my springs won't be worth the spindles they're sprung to…

>l
Darkness
It is pitch dark, and you can't see a thing.

The Abbot's voice is getting closer. The old man may move slower than a short hand, but he's definitely coming this way.

* * *

>close clock
You close Abbot Gubbler's Grandfather clock.

From the hallway outside comes the echo of voices. Too shaky to be Calvin or Drake. More like - oh, no. It's the Abbot, coming back to his room. And if he finds me here, then my springs won't be worth the spindles they're sprung to…

>x keyhole
You see nothing special about the keyhole.

The Abbot's voice is getting closer. The old man may move slower than a short hand, but he's definitely coming this way.

>x penduluum
You can't see any such thing.

>x robe
You can't see any such thing.

>l
Abbot Gubbler's Grandfather clock
In Abbot Gubbler's Grandfather clock you can see a robe, a penduluum and two counterweights.

Oh, widdershins! Gubbler is right outside the door! I'd better hide!

* * *

>close clock
You close Abbot Gubbler's Grandfather clock.

From the hallway outside comes the echo of voices. Too shaky to be Calvin or Drake. More like - oh, no. It's the Abbot, coming back to his room. And if he finds me here, then my springs won't be worth the spindles they're sprung to…

>x robe
You see nothing special about the robe.

The Abbot's voice is getting closer. The old man may move slower than a short hand, but he's definitely coming this way.

>x penduluum
You see nothing special about the penduluum.

Oh, widdershins! Gubbler is right outside the door! I'd better hide!

>x keyhole
You see nothing special about the keyhole.

>showme
Abbot's Quarters - room
    *Bust of St. Newton
    Abbot Gubbler's Grandfather clock - closed container
        keyhole (part of Abbot Gubbler's Grandfather clock)
        yourself - person
            my lucky clock key (worn)
                string (part of my lucky clock key)
            rag
            tumbler - open container
        robe
        penduluum
        two counterweights
* denotes things which are not in scope

>l
Abbot Gubbler's Grandfather clock
In Abbot Gubbler's Grandfather clock you can see a robe, a penduluum and two counterweights.

>get counterweight
Taken.

>inv
I am carrying:
  two counterweights
  my lucky clock key (being worn)
  a rag
  a tumbler

>l
Abbot Gubbler's Grandfather clock
In Abbot Gubbler's Grandfather clock you can see a robe and a penduluum.

>drop one counterweight
Dropped.

>inv
I am carrying:
  my lucky clock key (being worn)
  a rag
  a tumbler

>l
Abbot Gubbler's Grandfather clock
In Abbot Gubbler's Grandfather clock you can see two counterweights, a robe and a penduluum.

* * *

>open clock
I open the clock door and peek inside. For a big clock it's got a pretty small penduluum, about the size of Calvin's fist and not as big as Drake's. There's even enough space in front of it for the Abbot to hang up one of his spare robes.

"And don't come out till that clock's shining!" shouts Drake from the hall.

"Yeah," Calvin says. "It's got to look as good as if we did it!"

"Idiot," Drake mutters. "Come on."

Their voices disappear down the hall.

>x robe
It's a thick black woollen habit, with a long deep hood and sleeves big enough to fit a five-and-a-quarter transmission with room to spare. Being the Abbot's robe means it has a softer lining, and a little sewn-in pocket for his tissues, spectacles, and that sort of thing.

The grandfather clock ticks off a minute with a stately thunk. Quickly, I make the sign of the winding gear.

>x keyhole
You can't see any such thing.

>enter clock
You get into Abbot Gubbler's Grandfather clock.

In Abbot Gubbler's Grandfather clock you can see a robe, a penduluum and two counterweights.

The grandfather clock ticks off a minute with a stately thunk. Quickly, I make the sign of the winding gear.

>x keyohle
You can't see any such thing.

>x keyhole
You see nothing special about the keyhole.

From the hallway outside comes the echo of voices. Too shaky to be Calvin or Drake. More like - oh, no. It's the Abbot, coming back to his room. And if he finds me here, then my springs won't be worth the spindles they're sprung to…

>close door
You can't see any such thing.

>close clock
You close Abbot Gubbler's Grandfather clock.

The Abbot's voice is getting closer. The old man may move slower than a short hand, but he's definitely coming this way.

It is now pitch dark in here!

>l
Darkness
It is pitch dark, and you can't see a thing.

Oh, widdershins! Gubbler is right outside the door! I'd better hide!

>x keyhole
It is pitch dark, and you can't see a thing.

* * *

>x robe
It's a thick black woollen habit, with a long deep hood and sleeves big enough to fit a five-and-a-quarter transmission with room to spare. Being the Abbot's robe means it has a softer lining, and a little sewn-in pocket for his tissues, spectacles, and that sort of thing.

The grandfather clock ticks off a minute with a stately thunk. Quickly, I make the sign of the winding gear.

>get robe
Better not. My fingers are all greasy with polish.

From the hallway outside comes the echo of voices. Too shaky to be Calvin or Drake. More like - oh, no. It's the Abbot, coming back to his room. And if he finds me here, then my springs won't be worth the spindles they're sprung to…

>wear robe
(first taking the robe)
Better not. My fingers are all greasy with polish.

The Abbot's voice is getting closer. The old man may move slower than a short hand, but he's definitely coming this way.

>enter clock
"We'll talk in here," I hear the Abbot saying, from right outside the door. "More private. More quiet. Much better." The old man steps inside the room, followed by a tall figure in grey. In the last tick before his old eyes can see me, I dive inside the gigantic clock case and pull closed the door.

Inside Clock Case
As the phrase goes, I'm stuck between a rack and a gear-trace; except here I'm in the narrow gap between the clock case door and the heavy swinging penduluum behind. And if that hit me, and disrupted the holy timings… well, there's no way they wouldn't notice when the clock-hands stopped moving, let's just say.

A little light shines in through the keyhole, which is almost covered by the Abbott's spare robe.

Oh, no… That click outside was the sound of the Abbot closing the door. Looks like he - and the grey figure I glimpsed with him - are going to be here for a while…

>x keyhole
Through the keyhole I can see the corner of the Abbot's desk, but the Abbot and the Figure have gone.

* * *

>open clock
I open the clock door and peek inside. For a big clock it's got a pretty small penduluum, about the size of Calvin's fist and not as big as Drake's. There's even enough space in front of it for the Abbot to hang up one of his spare robes.

"And don't come out till that clock's shining!" shouts Drake from the hall.

"Yeah," Calvin says. "It's got to look as good as if we did it!"

"Idiot," Drake mutters. "Come on."

Their voices disappear down the hall.

>x penduluum
The penduluum is a large amount of Holy Brass, properly blessed and bevelled. It swings back and forth, raising the weight of Precision against the counterweight of Slapdashery.

The grandfather clock ticks off a minute with a stately thunk. Quickly, I make the sign of the winding gear.

>touch penduluum
To stop a clock is like murder. To shift the balance…. that's something even worse still.

From the hallway outside comes the echo of voices. Too shaky to be Calvin or Drake. More like - oh, no. It's the Abbot, coming back to his room. And if he finds me here, then my springs won't be worth the spindles they're sprung to…

* * *

>search clock
I open the clock door and peek inside. For a big clock it's got a pretty small penduluum, about the size of Calvin's fist and not as big as Drake's. There's even enough space in front of it for the Abbot to hang up one of his spare robes.

"And don't come out till that clock's shining!" shouts Drake from the hall.

"Yeah," Calvin says. "It's got to look as good as if we did it!"

"Idiot," Drake mutters. "Come on."

Their voices disappear down the hall.

* * *

>enter clock
I should polish the outside of the clock first, and that'll probably take more than long enough.

"And don't come out till that clock's shining!" shouts Drake from the hall.

"Yeah," Calvin says. "It's got to look as good as if we did it!"

"Idiot," Drake mutters. "Come on."

Their voices disappear down the hall.

>polish clock
I whisper the correct mantra against the evils of Friction and Dust, and start polishing. This'll take forever!

The grandfather clock ticks off a minute with a stately thunk. Quickly, I make the sign of the winding gear.

* * *

>x clock
No wonder Calvin and Drake didn't want to do this. Abbot Gubbler's Grandfather clock is enormous: the face is the size of a dinnerplate and the cabinet below is big enough to be a wardrobe. Even just polishing the doors will take half an hour. The whole thing might take all day.

From the hallway outside comes the echo of voices. Too shaky to be Calvin or Drake. More like - oh, no. It's the Abbot, coming back to his room. And if he finds me here, then my springs won't be worth the spindles they're sprung to…

>put rag in polish
You can't see any such thing.

>put rag in tumbler
You put the rag into the tumbler.

The Abbot's voice is getting closer. The old man may move slower than a short hand, but he's definitely coming this way.

>hide
I didn't understand that sentence.

>look behind clock
I only understood you as far as wanting to look.

>look behind clock
I only understood you as far as wanting to look.

>look under clock
You find nothing of interest.

Oh, widdershins! Gubbler is right outside the door! I'd better hide!

>enter clock
"We'll talk in here," I hear the Abbot saying, from right outside the door. "More private. More quiet. Much better." The old man steps inside the room, followed by a tall figure in grey. In the last tick before his old eyes can see me, I dive inside the gigantic clock case and pull closed the door.

Inside Clock Case
As the phrase goes, I'm stuck between a rack and a gear-trace; except here I'm in the narrow gap between the clock case door and the heavy swinging penduluum behind. And if that hit me, and disrupted the holy timings… well, there's no way they wouldn't notice when the clock-hands stopped moving, let's just say.

A little light shines in through the keyhole, which is almost covered by the Abbott's spare robe.

You can also see a robe, a penduluum and two counterweights here.

* * *

>enter clock
I should polish the outside of the clock first, and that'll probably take more than long enough.

"And don't come out till that clock's shining!" shouts Drake from the hall.

"Yeah," Calvin says. "It's got to look as good as if we did it!"

"Idiot," Drake mutters. "Come on."

Their voices disappear down the hall.

>enter clock
I should polish the outside of the clock first, and that'll probably take more than long enough.

The grandfather clock ticks off a minute with a stately thunk. Quickly, I make the sign of the winding gear.

>enter clock
I should polish the outside of the clock first, and that'll probably take more than long enough.

From the hallway outside comes the echo of voices. Too shaky to be Calvin or Drake. More like - oh, no. It's the Abbot, coming back to his room. And if he finds me here, then my springs won't be worth the spindles they're sprung to…

* * *

>z
Time passes.

"I told you now didn't I tell you?" old Abbot Gubbler is saying, plaintively. "Here? Why here? You shouldn't have come here."

The Figure says something in reply. I can only hear two words, but they're enough to stop my heart. "Failure," and "Consequences."

>z
Time passes.

>empty polish
Oh… well, then. I tip out the last of the polish onto the floor of the clock. At least that part will shine.

* * *

>z
Time passes.

"I told you now didn't I tell you?" old Abbot Gubbler is saying, plaintively. "Here? Why here? You shouldn't have come here."

The Figure says something in reply. I can only hear two words, but they're enough to stop my heart. "Failure," and "Consequences."

>ouy
I didn't understand that sentence.

>out
You've got a spring missing if you think I can slip out, unnoticed, or come up with a decent excuse as to why I've been hiding in the Abbot's grandfather. No, I'm staying put and hoping nothing happens to make the old man need to change his clothes.

"But these things, these things are not always tick-tock, they never are," the old man replies. His voice is quivering, quite different from the steady drone he has when intoning in Chapel. "The - item you asked about - it's in the Vaults, you see? The Vaults. Even if I could get in, I …"

The Figure is too far from the keyhole and speaks too quietly for me to hear clearly. "Disappointing," he says; and then "unslip your gears."

>out
You've got a spring missing if you think I can slip out, unnoticed, or come up with a decent excuse as to why I've been hiding in the Abbot's grandfather. No, I'm staying put and hoping nothing happens to make the old man need to change his clothes.

The Abbot is spluttering and choking. You've seen him like this only once, when as a young initiate you dropped and smashed an altimeter right before the Archbishop was due to visit.

The Figure's quiet voice continues. I can make out; "too old to steal", "a better mechanism", "the opportunity."

The Abbot nods violently, shaking out agreement the way I might beat dirt from a duster. "My money?" he asks.

>out
You've got a spring missing if you think I can slip out, unnoticed, or come up with a decent excuse as to why I've been hiding in the Abbot's grandfather. No, I'm staying put and hoping nothing happens to make the old man need to change his clothes.

There's the clink, of a pouch of golden minutes. A heavy pouch. The Figure, paying the Abbot…? Then suddenly, there's a third voice. "Sorry, Father, to interrupt, but you said…"

It's a monk of the Abbey. "Get out!" the Abbot screeches. His bearing's lost its oil, it seems. "Get out, get out!"

"But Father," the monk continues, "it's time, you know. You told me to tell you when it was time."

"Oh! Of course of course," he mumbles. "I'll… We'll continue this discussion later, then," he says, to the Figure.

The Figure intones something in reply.

The Abbot leaves, and that leaves me alone, inside this clock, with the stranger outside. He's coming nearer… I can hear his fingers on the door of the case! I must have nudged the penduluum, he must have seen the clock-hands quiver… but then, there's the swish of his cloak as he moves away, and the click as the door closes. Phew.

>out
I spill gratefully out of the clock, gasping for breath as though I've been underwater. I've just been holding it in, of course. As what I've heard - well, I probably shouldn't have, and the quicker I can get out of here, the better.

Abbot's Quarters
If I thought Abbots lived in luxury, then I was dead wrong. Even my attic's cosier than this. The Abbot's got no furniture at all, except a desk and a cot, and no decoration except for a bust of St. Newton. None of the axle-mounted bevelled mobiles I was expecting. There's barely even any sunlight: one thin window to catch the sun-rise, opposite the door to the hallway back west.

St. Newton is staring at the Abbot's unpolished Grandfather clock with a severe frown.

* * *

>d
I scramble quickly down the ladder.

Rickety Stair
I'm in one corner of the Great Hall, just by the foot of the ladder up to my room. There's a note attached to it, asking Amble the caretaker not to put it back in the shed just yet.

* * *

>w
Library
The Abbey's library is small compared to the one in the Cathedral. There's nothing on the shelves but the key texts: the Principia, the Mechanistica and the Determininium. Only Brother Horloge, the Abbey's Primary Reader ever seems to use them - he's here at the moment, studying at his desk by the poor light coming through the stained glass windows. By his elbow is a fat bunch of keys. On his shoulder is his mechanical owl, wings folded.

An archway leads east back into the hall. From the southwest comes the clatter of Writing hammers and the sharp smell of burnt ink.

>sw
Scriptorium

>e
Lower Hall
Looking northeast, the Great Hall of the Abbey stretches away like the belly of some big beast, its bony roof held up by pillars like swallowed trees. The walls are carelessly lit by candles moving through Sacred Tracks suspended in the air. I can just make out the Corridor of Contemplation to the east, and the wider archway to the Scriptorium to the west.

But more importantly, the great Entry - and exit - of the Abbey is to the southwest. And if I'm going to get out of here and talk to the Archbishop that's the only way to go.

But maybe you're starting to see what kind of luck I have. Right there, in the Entry, is Calvin, working on a clock.

>sw
I can't go that way.

>ne
Center Hall
I'm standing in the very centre of the Abbey's Great Hall. It's impossible not to crane my neck here, to gaze up at the ceiling held aloft by buttresses like gigantic oak trees. To think, people built this in the days before proper pulley-transmissions! It must have taken weeks! The hall continues northeast into shadow, and southwest, towards the sunlight, the Yard and above all, the Archbishop.

The vast empty space is filled by the muttering and echo of Holy Mechanisms, and the hiss of the candles as they sweep around their Tracks, providing a little light everywhere but rarely ever enough. I can just make out archways both east and west.

>e
West Refectory

>e
East Refectory

>n
Kitchen
If there was ever a proof of the perfection of Clockwork over Nature, it's that the dirtiest and most hectic room in the whole Abbey is its Kitchen. Shelves, walls and floor are covered by machines belching, slicing, steaming, chopping, stirring, boiling, broiling, frying, pureeing … the list goes on. The noise, smell and heat is almost overpowering, and the Cook, who controls this madhouse, can only stand it because he's stone deaf.

>w
Upper Hall
The Great Hall of the Abbey is the biggest room I've seen in my life, running from this end all the way southwest (and it is all the way, I'm never allowed further) to the Great Doors and the Yard outside. If I crane my neck I can see the dark square of the floorboards of my room - the ladder is on one side, to the west. Lights moves in and out overhead, from the candles moving on their Holy Tracks. Strong smells float through an archway to the east.

From their niches, the Three Major Saints are watching sternly, keen that I should get out of the Cathedral and talk to the Archbishop as quickly as possible.

* * *

>enter clock
I can't, since Gubbler's Grandfather clock is in the way.

"I told you now didn't I tell you?" old Abbot Gubbler is saying, plaintively. "Here? Why here? You shouldn't have come here."

The Figure says something in reply. I can only hear two words, but they're enough to stop my heart. "Failure," and "Consequences."

>leave clock
I can't, since Gubbler's Grandfather clock is in the way.

"But these things, these things are not always tick-tock, they never are," the old man replies. His voice is quivering, quite different from the steady drone he has when intoning in Chapel. "The - item you asked about - it's in the Vaults, you see? The Vaults. Even if I could get in, I …"

The Figure is too far from the keyhole and speaks too quietly for me to hear clearly. "Disappointing," he says; and then "unslip your gears."

>actions
Actions listing on.

>leave clock
[entering Gubbler's Grandfather clock]
[(1) going Gubbler's Grandfather clock]
I can't, since Gubbler's Grandfather clock is in the way.
[(1) going Gubbler's Grandfather clock - failed the can't go through closed doors rule]

[entering Gubbler's Grandfather clock - failed the convert enter door into go rule]
The Abbot is spluttering and choking. You've seen him like this only once, when as a young initiate you dropped and smashed an altimeter right before the Archbishop was due to visit.

The Figure's quiet voice continues. I can make out; "too old to steal", "a better mechanism", "the opportunity."

The Abbot nods violently, shaking out agreement the way I might beat dirt from a duster. "My money?" he asks.

* * *

>enter clock
I should polish the outside of the clock first, and that'll probably take more than long enough.

"And don't come out till that clock's shining!" shouts Drake from the hall.

"Yeah," Calvin says. "It's got to look as good as if we did it!"

"Idiot," Drake mutters. "Come on."

Their voices disappear down the hall.

>enter door
(the Abbot's Door)
(first opening the Abbot's Door)
Curses to counterweights! It's not on my rota, this clock, so why should I finish off my polish on it? I head for the doorway - then freeze. Voices, coming down the hall. It's the Abbot himself, coming this way!

* * *

>enter clock
I should polish the outside of the clock first, and that'll probably take more than long enough.

"And don't come out till that clock's shining!" shouts Drake from the hall.

"Yeah," Calvin says. "It's got to look as good as if we did it!"

"Idiot," Drake mutters. "Come on."

Their voices disappear down the hall.

>undo
Abbot's Quarters
[Previous turn undone.]

>actions
Actions listing on.

>enter clock
[entering Gubbler's Grandfather clock]
I should polish the outside of the clock first, and that'll probably take more than long enough.
[entering Gubbler's Grandfather clock - failed]

"And don't come out till that clock's shining!" shouts Drake from the hall.

"Yeah," Calvin says. "It's got to look as good as if we did it!"

"Idiot," Drake mutters. "Come on."

Their voices disappear down the hall.

You must supply a noun.

>undo
Abbot's Quarters
[Previous turn undone.]

>rules
Rules tracing now switched on. Type "rules off" to switch it off again, or "rules all" to include even rules which do not apply.

>enter clock
[entering Gubbler's Grandfather clock]
    [Rule "Instead of entering the Grandfather Clock when in Abbot's Quarters and Voices have not been heard" applies.]
I should polish the outside of the clock first, and that'll probably take more than long enough.
[entering Gubbler's Grandfather clock - failed]

[Rule "Every turn when the number of entries in the current script is not 0" applies.]
[Rule "Rule for firing a scripted event ( called x )" applies.]
"And don't come out till that clock's shining!" shouts Drake from the hall.

"Yeah," Calvin says. "It's got to look as good as if we did it!"

"Idiot," Drake mutters. "Come on."

Their voices disappear down the hall.

You must supply a noun.

>z
[waiting]
    [Rule "First report waiting rule" applies.]
Time passes.

[waiting - succeeded]
[Rule "Every turn when the number of entries in the current script is not 0" applies.]
[Rule "Rule for firing a scripted event ( called x )" applies.]
The grandfather clock ticks off a minute with a stately thunk. Quickly, I make the sign of the winding gear.

[Rule "standard set going variables rule" applies.]
[Drake going northeast]
    [Rule "can't travel in what's not a vehicle rule" applies.]
    [Rule "can't go through undescribed doors rule" applies.]
    [Rule "can't go through closed doors rule" applies.]
    [Rule "determine map connection rule" applies.]
    [Rule "can't go that way rule" applies.]
    [Rule "move player and vehicle rule" applies.]
    [Rule "move floating objects rule" applies.]
    [Rule "check light in new location rule" applies.]
[Drake going northeast - succeeded]

* * *

>enter clock
I should polish the outside of the clock first, and that'll probably take more than long enough.

"And don't come out till that clock's shining!" shouts Drake from the hall.

"Yeah," Calvin says. "It's got to look as good as if we did it!"

"Idiot," Drake mutters. "Come on."

Their voices disappear down the hall.

>w
Curses to counterweights! It's not on my rota, this clock, so why should I finish off my polish on it? I head for the doorway - then freeze. Voices, coming down the hall. It's the Abbot himself, coming this way!

* * *

>listen
I put one ear to the keyhole but the Figure's voice is still too faint. But that's right and proper, isn't it? I shouldn't be eavesdropping on the Abbot's private conferences! I'd better just wait till he goes.

"I told you now didn't I tell you?" old Abbot Gubbler is saying, plaintively. "Here? Why here? You shouldn't have come here."

The Figure says something in reply. I can only hear two words, but they're enough to stop my heart. "Failure," and "Consequences."

>listen with tumbler
Oh… well, then. I tip out the last of the polish onto the floor of the clock. At least that part will shine.

I put the glass tumbler carefully against the door, then lean down to press my ear against it. Fantastic! I can hear much more clearly now!

"But these things, these things are not always tick-tock, they never are," the old man replies. His voice is quivering, quite different from the steady drone he has when intoning in Chapel. "The - item you asked about - it's in the Vaults, you see? The Vaults. Even if I could get in, I …"

"Your excuses we find disappointing. Very disappointing. More of this and, Abbot, we may need to unslip your gears completely."

>listen
The Abbot is spluttering and choking. You've seen him like this only once, when as a young initiate you dropped and smashed an altimeter right before the Archbishop was due to visit.

The Figure continues. "Clearly you're too old to steal the item for us. We have a better mechanism for obtaining it. But you must provide us with the opportunity. Is that understood?"

The Abbot nods violently, shaking out agreement the way I might beat dirt from a duster. "My money?" he asks.

>x abbot
I can't see much through the keyhole, except the Abbot's stout waist and shaking hands. Not much good for winding anything now, but if I said as much to anyone then I'd be in real trouble.

There's the clink, of a pouch of golden minutes. A heavy pouch. The Figure, paying the Abbot…? Then suddenly, there's a third voice. "Sorry, Father, to interrupt, but you said…"

It's a monk of the Abbey. "Get out!" the Abbot screeches. His bearing's lost its oil, it seems. "Get out, get out!"

"But Father," the monk continues, "it's time, you know. You told me to tell you when it was time."

"Oh! Of course of course," he mumbles. "I'll… We'll continue this discussion later, then," he says, to the Figure.

"We certainly will," the Figure replies.

The Abbot leaves, and that leaves me alone, inside this clock, with the stranger outside. He's coming nearer… I can hear his fingers on the door of the case! I must have nudged the penduluum, he must have seen the clock-hands quiver… but then, there's the swish of his cloak as he moves away, and the click as the door closes. Phew.

>x figure
I can't see any such thing.

>out
I spill gratefully out of the clock, gasping for breath as though I've been underwater. I've just been holding it in, of course. As what I've heard - well, I probably shouldn't have, and the quicker I can get out of here, the better.

Abbot's Quarters
If I thought Abbots lived in luxury, then I was dead wrong. Even my attic's cosier than this. The Abbot's got no furniture at all, except a desk and a cot, and no decoration except for a bust of St. Newton. None of the axle-mounted bevelled mobiles I was expecting. There's barely even any sunlight: one thin window to catch the sun-rise, opposite the door to the hallway back west.

St. Newton is staring at the Abbot's unpolished Grandfather clock with a severe frown.

>out
But I am not in anything at the moment.

>w
(first opening the Abbot's Door)
I'm going to have to tell someone what I just heard. A theft, from the Vaults! But if the Abbot's involved - then who else might be? After all, the figure he was talking to could have been anyone in the Abbey!

Corridor of Contemplation
The ancient stones of the Abbey rise to about shoulder-height before arching over, forcing me to bow my head in supplication before the Abbot's door, back east. To the west, I can hear the gentle echo of ticks and tocks coming from the Abbey's main hall.

Carved into the walls are a series of pious engravings, depicting the long path from initiate to Abbot.

>x engravings
If someone comes, that's what I'll do, to explain why I'm here. But no-one's coming, and that means I'd better get away, fast.

>e
No fear. I'm not going back in there.

>w
I dart of the tunnel, only to be stopped dead by a depressing sight. It's Calvin and Drake, hurrying in through the Abbey's Great Entry. Their mouths are white with sugar.

"Hey, you!" Drake shouts. In a moment he's got me by the ear. "What were you doing in the Abbot's room? That's not on your rota!"

"Yeah!" Calvin adds. "And why are you slipping away when we told you to be there?"

"Idiot," Drake hisses. Louder - for the benefit of any passing monks - he says, "That's it, Wren. You're consigned to your room." For good measure, he punches me on the arm, then the two of them drag me away, heels over flagstones, right to the bottom of the ladder.

"Up you go," Calvin says. "And you're not to come down till dark!"

"What about dinner?" I ask.

"Should have thought of that, shouldn't you?" Drake says.

"More for us," Calvin adds. "Only two hours to go. I'm starved."

With that, they punch me again, and wait until I scurry away up the ladder.

Attic Room
This isn't really an attic. It isn't really a room either. It's a couple of floorboards laid across some roof rafters right in the ceiling of the Abbey. There's enough floor-space for a cot and a laundry crate, but I have to be careful not to roll out of bed, because if I do, the thick cobwebs all around aren't going to stop me from falling….

A little hole in the ceiling provides some sunlight: and when it rains, it means I can wash my hair, too. It's right above the rickety ladder down to the ground (and that means the ladder is starting to rot and bend).

Through my window I can see the Cathedral across the yard outside. If I was a bird, I could escape easily, and tell someone what I've overheard. The Abbot's about to do something terrible and I've got to stop him! Someone at the Cathedral would listen: the Archbishop himself, perhaps. He might remember me from the time he visited, when he helped me repair an altimeter I'd broken. If only I could fly.

But perhaps I can escape on foot. If I'm clever. Clockwise.

* * *

>s
I can't go that way.

>sw
Center Hall
I'm standing in the very centre of the Abbey's Great Hall. It's impossible not to crane my neck here, to gaze up at the ceiling held aloft by buttresses like gigantic oak trees. To think, people built this in the days before proper pulley-transmissions! It must have taken weeks! The hall continues northeast into shadow, and southwest, towards the sunlight, the Yard and above all, the Archbishop.

The vast empty space is filled by the muttering and echo of Holy Mechanisms, and the hiss of the candles as they sweep around their Tracks, providing a little light everywhere but rarely ever enough. I can just make out archways both east and west.

* * *

>w
Library
The Abbey's library is small compared to the one in the Cathedral. There's nothing on the shelves but the key texts: the Principia, the Mechanistica and the Determininium. Only Brother Horloge, the Abbey's Primary Reader ever seems to use them - he's here at the moment, studying at his desk by the poor light coming through the stained glass windows. By his elbow is a fat bunch of keys. On his shoulder is his mechanical owl, wings folded.

An archway leads east back into the hall. From the southwest comes the clatter of Writing hammers and the sharp smell of burnt ink.

>sw
Scriptorium
The Scriptorium is where the Copying takes place, though it's hard to believe that Copying once meant a team of monks working with carved rubber stamps. It's all done by mechanisms now, of course, like everything else except my chores. There's the massive Gutenberg press on the west wall, and everywhere else is Brother Reloh's Duplicator. Twenty-three Typewriters, all clattering away as though operated by ghosts, all connected by a single Carriage Arm that curves the length of the wall. To leave the room east or northeast I'll have to duck under.

Reloh works on one of the keyboards of the Duplicator, typing furiously. The hammering and punching is almost overwhelming.

The Gutenberg seems to be in the midst of a repair. The Cabinet of Relics next to it is open.

>e
Lower Hall
Looking northeast, the Great Hall of the Abbey stretches away like the belly of some big beast, its bony roof held up by pillars like swallowed trees. The walls are carelessly lit by candles moving through Sacred Tracks suspended in the air. I can just make out the Corridor of Contemplation to the east, and the wider archway to the Scriptorium to the west.

But more importantly, the great Entry - and exit - of the Abbey is to the southwest. And if I'm going to get out of here and talk to the Archbishop that's the only way to go.

But maybe you're starting to see what kind of luck I have. Right there, in the Entry, is Calvin, working on a clock.

>ne
Center Hall
I'm standing in the very centre of the Abbey's Great Hall. It's impossible not to crane my neck here, to gaze up at the ceiling held aloft by buttresses like gigantic oak trees. To think, people built this in the days before proper pulley-transmissions! It must have taken weeks! The hall continues northeast into shadow, and southwest, towards the sunlight, the Yard and above all, the Archbishop.

The vast empty space is filled by the muttering and echo of Holy Mechanisms, and the hiss of the candles as they sweep around their Tracks, providing a little light everywhere but rarely ever enough. I can just make out archways both east and west.

>e
West Refectory
I spend some of my time here, eating at one of the two long tables. I spend even more serving the monks. Each of them has their own seat, marked by a little brass hourglass, and if the twenty or so I can see here weren't enough (which they aren't), there's more to the east, where the Refectory continues. Back west is the archway to the Great Hall.

On the table is a single empty teacup, left over from breakfast.

I've got a moment before Drake spots me: he's just appeared, to the east.

>e
Just in time, I see Drake's there. I hang back, to let him move on.

Distantly - but not distantly enough - I can hear the clock and clatter of Drake's boots. The sounds coming from the west.

>e
East Refectory
The eastern end of the long Refectory is given over in part to the tables lined with brass hourglasses, but in the other half there's nothing but the enormous Refectory Clock. It's an impressive thing, so big because it only needs winding once a year, despite all the gongs, cymbals, tubes and bells that strike when dinner time comes around. Right now, the clock is showing the time at just after 3pm.

Pungent smells drift in from the kitchen to the north. On the east wall is the small green door to the Abbey's herb garden.

>w
West Refectory
I spend some of my time here, eating at one of the two long tables. I spend even more serving the monks. Each of them has their own seat, marked by a little brass hourglass, and if the twenty or so I can see here weren't enough (which they aren't), there's more to the east, where the Refectory continues. Back west is the archway to the Great Hall.

On the table is a single empty teacup, left over from breakfast.

>w
Center Hall
I'm standing in the very centre of the Abbey's Great Hall. It's impossible not to crane my neck here, to gaze up at the ceiling held aloft by buttresses like gigantic oak trees. To think, people built this in the days before proper pulley-transmissions! It must have taken weeks! The hall continues northeast into shadow, and southwest, towards the sunlight, the Yard and above all, the Archbishop.

The vast empty space is filled by the muttering and echo of Holy Mechanisms, and the hiss of the candles as they sweep around their Tracks, providing a little light everywhere but rarely ever enough. I can just make out archways both east and west.

>z
Time passes.

Looking southwest, I can see Drake. He's coming this way!

>z
Time passes.

Drake's on patrol, and I can hear him heading this way, from the northeast.

>z
Time passes.

Drake goes northeast.

>z
Time passes.

>z
Time passes.

Drake's just off to the east, and he's coming this way!

>z
Time passes.

Drake's footsteps echo in from the west.

>z
Time passes.

Drake goes west.

>x drake
I can't see any such thing.

>x drake
I can't see any such thing.

>z
Time passes.

>x drake
I can't see any such thing.

>z
Time passes.

I've got a moment before Drake spots me: he's just appeared, to the southwest.

>x drake
I can't see any such thing.

>z
Time passes.

Drake's on patrol, and I can hear him heading this way, from the northeast.

>x drake
I see nothing special about Drake.

Drake goes northeast.

>ne
Just in time, I see Drake's there. I hang back, to let him move on.

>ne
Upper Hall
The Great Hall of the Abbey is the biggest room I've seen in my life, running from this end all the way southwest (and it is all the way, I'm never allowed further) to the Great Doors and the Yard outside. If I crane my neck I can see the dark square of the floorboards of my room - the ladder is on one side, to the west. Lights moves in and out overhead, from the candles moving on their Holy Tracks. Strong smells float through an archway to the east.

From their niches, the Three Major Saints are watching sternly, keen that I should get out of the Cathedral and talk to the Archbishop as quickly as possible.

>e
Kitchen
If there was ever a proof of the perfection of Clockwork over Nature, it's that the dirtiest and most hectic room in the whole Abbey is its Kitchen. Shelves, walls and floor are covered by machines belching, slicing, steaming, chopping, stirring, boiling, broiling, frying, pureeing … the list goes on. The noise, smell and heat is almost overpowering, and the Cook, who controls this madhouse, can only stand it because he's stone deaf.

>s
East Refectory
The eastern end of the long Refectory is given over in part to the tables lined with brass hourglasses, but in the other half there's nothing but the enormous Refectory Clock. It's an impressive thing, so big because it only needs winding once a year, despite all the gongs, cymbals, tubes and bells that strike when dinner time comes around. Right now, the clock is showing the time at just after 3pm.

Pungent smells drift in from the kitchen to the north. On the east wall is the small green door to the Abbey's herb garden.

>w
West Refectory
I spend some of my time here, eating at one of the two long tables. I spend even more serving the monks. Each of them has their own seat, marked by a little brass hourglass, and if the twenty or so I can see here weren't enough (which they aren't), there's more to the east, where the Refectory continues. Back west is the archway to the Great Hall.

On the table is a single empty teacup, left over from breakfast.

* * *

>sw
I catch the sound of hobnailed boots. Drake's heading this way! I'd better wait, and let him pass.

Drake's just off to the southwest, and he's coming this way!

>x drake
I can't see any such thing.

>z
Time passes.

Drake's clattering boots are audible to the northeast.

* * *

>sw
Center Hall
I'm standing in the very centre of the Abbey's Great Hall. It's impossible not to crane my neck here, to gaze up at the ceiling held aloft by buttresses like gigantic oak trees. To think, people built this in the days before proper pulley-transmissions! It must have taken weeks! The hall continues northeast into shadow, and southwest, towards the sunlight, the Yard and above all, the Archbishop.

The vast empty space is filled by the muttering and echo of Holy Mechanisms, and the hiss of the candles as they sweep around their Tracks, providing a little light everywhere but rarely ever enough. I can just make out archways both east and west.

Drake's just off to the east, and he's coming this way!

>x drake
I can't see any such thing.

>e
Just in time, I see Drake's there. I hang back, to let him move on.

Distantly - but not distantly enough - I can hear the clock and clatter of Drake's boots. The sounds coming from the west.

* * *

>close clock
That's already closed.

"I told you now didn't I tell you?" old Abbot Gubbler is saying, plaintively. "Here? Why here? You shouldn't have come here."

The Figure says something in reply. I can only hear two words, but they're enough to stop my heart. "Failure," and "Consequences."

>open clock
You've got a spring missing if you think I can slip out, unnoticed, or come up with a decent excuse as to why I've been hiding in the Abbot's grandfather. No, I'm staying put and hoping nothing happens to make the old man need to change his clothes.

"But these things, these things are not always tick-tock, they never are," the old man replies. His voice is quivering, quite different from the steady drone he has when intoning in Chapel. "The - item you asked about - it's in the Vaults, you see? The Vaults. Even if I could get in, I …"

The Figure is too far from the keyhole and speaks too quietly for me to hear clearly. "Disappointing," he says; and then "unslip your gears."

>x old man
I can't see much through the keyhole, except the Abbot's stout waist and shaking hands. Not much good for winding anything now, but if I said as much to anyone then I'd be in real trouble.

The Abbot is spluttering and choking. You've seen him like this only once, when as a young initiate you dropped and smashed an altimeter right before the Archbishop was due to visit.

The Figure's quiet voice continues. I can make out; "too old to steal", "a better mechanism", "the opportunity."

The Abbot nods violently, shaking out agreement the way I might beat dirt from a duster. "My money?" he asks.

>x man
Which do I mean, the figure in grey or Abbot Gubbler?

>out
You've got a spring missing if you think I can slip out, unnoticed, or come up with a decent excuse as to why I've been hiding in the Abbot's grandfather. No, I'm staying put and hoping nothing happens to make the old man need to change his clothes.

There's the clink, of a pouch of golden minutes. A heavy pouch. The Figure, paying the Abbot…? Then suddenly, there's a third voice. "Sorry, Father, to interrupt, but you said…"

It's a monk of the Abbey. "Get out!" the Abbot screeches. His bearing's lost its oil, it seems. "Get out, get out!"

"But Father," the monk continues, "it's time, you know. You told me to tell you when it was time."

"Oh! Of course of course," he mumbles. "I'll… We'll continue this discussion later, then," he says, to the Figure.

The Figure intones something in reply.

The Abbot leaves, and that leaves me alone, inside this clock, with the stranger outside. He's coming nearer… I can hear his fingers on the door of the case! I must have nudged the penduluum, he must have seen the clock-hands quiver… but then, there's the swish of his cloak as he moves away, and the click as the door closes. Phew.

* * *

>w
I'm going to have to tell someone what I just heard. A theft, from the Vaults! But if the Abbot's involved - then who else might be? After all, the figure he was talking to could have been anyone in the Abbey!

Corridor of Contemplation
The ancient stones of the Abbey rise to about shoulder-height before arching over, forcing me to bow my head in supplication before the Abbot's door, back east. To the west, I can hear the gentle echo of ticks and tocks coming from the Abbey's main hall.

Carved into the walls are a series of pious engravings, depicting the long path from initiate to Abbot.

>e
No fear. I'm not going back in there.

* * *

>close door
I close the Abbot's Door.

>e
I knock before entering the Abbot's study.

No fear. I'm not going back in there.

>e
I can't go that way.

>close door
(the Abbot's Door)
I close the Abbot's Door.

>scenes
Scene 'Entire Game' playing (for 14 mins now)
Scene 'Introduction' playing (for 14 mins now)
Scene 'Hiding in the clock' ended 
(Scene monitoring now switched on. Type "scenes off" to switch it off again.)

* * *

>enter newton
That's not something you can enter.

"And don't come out till that clock's shining!" shouts Drake from the hall.

"Yeah," Calvin says. "It's got to look as good as if we did it!"

"Idiot," Drake mutters. "Come on."

Their voices disappear down the hall.

* * *

>hide in clock
I should polish the outside of the clock first, and that'll probably take more than long enough.

"And don't come out till that clock's shining!" shouts Drake from the hall.

"Yeah," Calvin says. "It's got to look as good as if we did it!"

"Idiot," Drake mutters. "Come on."

Their voices disappear down the hall.

>w
Curses to counterweights! It's not on my rota, this clock, so why should I finish off my polish on it? I head for the doorway - then freeze. Voices, coming down the hall. It's the Abbot himself, coming this way!

>hide in clock
"We'll talk in here," I hear the Abbot saying, from right outside the door. "More private. More quiet. Much better." The old man steps inside the room, followed by a tall figure in grey. In the last tick before his old eyes can see me, I dive inside the gigantic clock case and pull closed the door.

Inside Clock Case
As the phrase goes, I'm stuck between a rack and a gear-trace; except here I'm in the narrow gap between the clock case door and the heavy swinging penduluum behind. And if that hit me, and disrupted the holy timings… well, there's no way they wouldn't notice when the clock-hands stopped moving, let's just say.

A little light shines in through the keyhole, which is almost covered by the Abbot's spare robe.

Oh, no… That click outside was the sound of the Abbot closing the door. Looks like he - and the grey figure I glimpsed with him - are going to be here for a while…

>listen with tumbler
Oh… well, then. I tip out the last of the polish onto the floor of the clock. At least that part will shine.

I put the glass tumbler carefully against the door, then lean down to press my ear against it. Fantastic! I can hear much more clearly now!

"I told you now didn't I tell you?" old Abbot Gubbler is saying, plaintively. "Here? Why here? You shouldn't have come here."

The Figure says something in reply. With the glass, I can hear quite clearly. That was a good idea. "We have been disappointed with your failure. The cause and effect principle, Abbot. Such failure must bring consequences."

* * *

>undo
Inside Clock Case
[Previous turn undone.]

>x figure
The glimpse I caught earlier was a tall - man? - wearing a suit of grey leather and a long flowing cape. Now I can't see him at all - it's almost as though he knows I'm hiding, and he's avoiding the keyhole's line of sight.

There's the clink, of a pouch of golden minutes. A heavy pouch. The Figure, paying the Abbot…? Then suddenly, there's a third voice. "Sorry, Father, to interrupt, but you said…"

It's a monk of the Abbey. "Get out!" the Abbot screeches. His bearing's lost its oil, it seems. "Get out, get out!"

"But Father," the monk continues, "it's time, you know. You told me to tell you when it was time."

"Oh! Of course of course," he mumbles. "I'll… We'll continue this discussion later, then," he says, to the Figure.

"We certainly will," the Figure replies.

The Abbot leaves, and that leaves me alone, inside this clock, with the stranger outside. He's coming nearer… I can hear his fingers on the door of the case! I must have nudged the penduluum, he must have seen the clock-hands quiver… but then, there's the swish of his cloak as he moves away, and the click as the door closes. Phew.

>out
I spill gratefully out of the clock, gasping for breath as though I've been underwater. I've just been holding it in, of course. As what I've heard - well, I probably shouldn't have, and the quicker I can get out of here, the better.

Abbot's Quarters
If I thought Abbots lived in luxury, then I was dead wrong. Even my attic's cosier than this. The Abbot's got no furniture at all, except a desk and a cot, and no decoration except for a bust of St. Newton. None of the axle-mounted bevelled mobiles I was expecting. There's barely even any sunlight: one thin window to catch the sun-rise, opposite the door to the hallway back west.

St. Newton is staring at the Abbot's unpolished Grandfather clock with a severe frown.

* * *

>w
I dart of the tunnel, only to be stopped dead by a depressing sight. It's Calvin and Drake, hurrying in through the Abbey's Great Entry. Their mouths are white with sugar.

"Hey, you!" Drake shouts. In a moment he's got me by the ear. "What were you doing in the Abbot's room? That's not on your rota!"

"Yeah!" Calvin adds. "And why are you slipping away when we told you to be there?"

"Idiot," Drake hisses. Louder - for the benefit of any passing monks - he says, "That's it, Wren. You're consigned to your room." For good measure, he punches me on the arm, then the two of them drag me away, heels over flagstones, right to the bottom of the ladder.

"Up you go," Calvin says. "And you're not to come down till dark!"

"What about dinner?" I ask.

"Should have thought of that, shouldn't you?" Drake says.

"More for us," Calvin adds. "Only two hours to go. I'm starved."

With that, they punch me again, and wait until I scurry away up the ladder.

Attic Room
This isn't really an attic. It isn't really a room either. It's a couple of floorboards laid across some roof rafters right in the ceiling of the Abbey. There's enough floor-space for a cot and a laundry crate, but I have to be careful not to roll out of bed, because if I do, the thick cobwebs all around aren't going to stop me from falling….

A little hole in the ceiling provides some sunlight: and when it rains, it means I can wash my hair, too. It's right above the rickety ladder down to the ground (and that means the ladder is starting to rot and bend).

I can see a picture here.

Through my window I can see the Cathedral across the yard outside. If I was a bird, I could escape easily, and tell someone what I've overheard. The Abbot's about to do something terrible and I've got to stop him! Someone at the Cathedral would listen: the Archbishop himself, perhaps. He might remember me from the time he visited, when he helped me repair an altimeter I'd broken. If only I could fly.

But perhaps I can escape on foot. If I'm clever. Clockwise.

* * *

>e
West Refectory
I spend some of my time here, eating at one of the two long tables. I spend even more serving the monks. Each of them has their own seat, marked by a little brass hourglass, and if the twenty or so I can see here weren't enough (which they aren't), there's more to the east, where the Refectory continues. Back west is the archway to the Great Hall.

On the table is a single empty teacup, left over from breakfast.

Looking west, I can see Drake. He's coming this way!

>ne
I can't go that way.

"Wren!" Drake exclaims. He wallops me on the arm. "I thought I told you to stay in your room?" He doesn't wait for an excuse before I'm dragged off to the ladder. Then he waits - and wallops me - until I give in and climb all the way back up.

Attic Room
This isn't really an attic. It isn't really a room either. It's a couple of floorboards laid across some roof rafters right in the ceiling of the Abbey. There's enough floor-space for a cot and a laundry crate, but I have to be careful not to roll out of bed, because if I do, the thick cobwebs all around aren't going to stop me from falling….

A little hole in the ceiling provides some sunlight: and when it rains, it means I can wash my hair, too. It's right above the rickety ladder down to the ground (and that means the ladder is starting to rot and bend).

I can see a picture here.

That was careless, getting caught. But I can still make it to the Cathedral. I'll just have to be more cunning this time. Remember, Wren, it's easy: the whole world runs on clockwork. Just a matter of staying ahead of the biting teeth.

>undo
West Refectory
[Previous turn undone.]

>n
I can't go that way.

"Wren!" Drake exclaims. He wallops me on the arm. "I thought I told you to stay in your room?" He doesn't wait for an excuse before I'm dragged off to the ladder. Then he waits - and wallops me - until I give in and climb all the way back up.

Attic Room
This isn't really an attic. It isn't really a room either. It's a couple of floorboards laid across some roof rafters right in the ceiling of the Abbey. There's enough floor-space for a cot and a laundry crate, but I have to be careful not to roll out of bed, because if I do, the thick cobwebs all around aren't going to stop me from falling….

A little hole in the ceiling provides some sunlight: and when it rains, it means I can wash my hair, too. It's right above the rickety ladder down to the ground (and that means the ladder is starting to rot and bend).

I can see a picture here.

That was careless, getting caught. But I can still make it to the Cathedral. I'll just have to be more cunning this time. Remember, Wren, it's easy: the whole world runs on clockwork. Just a matter of staying ahead of the biting teeth.

>undo
West Refectory
[Previous turn undone.]

>e
East Refectory
The eastern end of the long Refectory is given over in part to the tables lined with brass hourglasses, but in the other half there's nothing but the enormous Refectory Clock. It's an impressive thing, so big because it only needs winding once a year, despite all the gongs, cymbals, tubes and bells that strike when dinner time comes around. Right now, the clock is showing the time at just after 3pm.

Pungent smells drift in from the kitchen to the north. On the east wall is the small green door to the Abbey's herb garden.

Drake's just off to the west, and he's coming this way!

I beg your pardon?

>n
Kitchen
If there was ever a proof of the perfection of Clockwork over Nature, it's that the dirtiest and most hectic room in the whole Abbey is its Kitchen. Shelves, walls and floor are covered by machines belching, slicing, steaming, chopping, stirring, boiling, broiling, frying, pureeing … the list goes on. The noise, smell and heat is almost overpowering, and the Cook, who controls this madhouse, can only stand it because he's stone deaf.

I've got a moment before Drake spots me: he's just appeared, to the south.

* * *

>sw
Center Hall
I'm standing in the very centre of the Abbey's Great Hall. It's impossible not to crane my neck here, to gaze up at the ceiling held aloft by buttresses like gigantic oak trees. To think, people built this in the days before proper pulley-transmissions! It must have taken weeks! The hall continues northeast into shadow, and southwest, towards the sunlight, the Yard and above all, the Archbishop.

The vast empty space is filled by the muttering and echo of Holy Mechanisms, and the hiss of the candles as they sweep around their Tracks, providing a little light everywhere but rarely ever enough. I can just make out archways both east and west.

I've got a moment before Drake spots me: he's just appeared, to the northeast.

>e
West Refectory
I spend some of my time here, eating at one of the two long tables. I spend even more serving the monks. Each of them has their own seat, marked by a little brass hourglass, and if the twenty or so I can see here weren't enough (which they aren't), there's more to the east, where the Refectory continues. Back west is the archway to the Great Hall.

On the table is a single empty teacup, left over from breakfast.

* * *

>w
Just in time, I see Drake's there. I hang back, to let him move on.

>w
Center Hall
I'm standing in the very centre of the Abbey's Great Hall. It's impossible not to crane my neck here, to gaze up at the ceiling held aloft by buttresses like gigantic oak trees. To think, people built this in the days before proper pulley-transmissions! It must have taken weeks! The hall continues northeast into shadow, and southwest, towards the sunlight, the Yard and above all, the Archbishop.

The vast empty space is filled by the muttering and echo of Holy Mechanisms, and the hiss of the candles as they sweep around their Tracks, providing a little light everywhere but rarely ever enough. I can just make out archways both east and west.

Distantly - but not distantly enough - I can hear the clock and clatter of Drake's boots. The sound's coming from the west.

>sw
Lower Hall
Looking northeast, the Great Hall of the Abbey stretches away like the belly of some big beast, its bony roof held up by pillars like swallowed trees. The walls are carelessly lit by candles moving through Sacred Tracks suspended in the air. I can just make out the Corridor of Contemplation to the east, and the wider archway to the Scriptorium to the west.

But more importantly, the great Entry - and exit - of the Abbey is to the southwest. And if I'm going to get out of here and talk to the Archbishop that's the only way to go.

But maybe you're starting to see what kind of luck I have. Right there, in the Entry, is Calvin, working on a clock.

* * *

>n
I can't go that way.

>undo
Scriptorium
[Previous turn undone.]

>ne
Library
The Abbey's library is small compared to the one in the Cathedral. There's nothing on the shelves but the key texts: the Principia, the Mechanistica and the Determininium. Only Brother Horloge, the Abbey's Primary Reader ever seems to use them - he's here at the moment, studying at his desk by the poor light coming through the stained glass windows. By his elbow is a fat bunch of keys. On his shoulder is his mechanical owl, wings folded.

An archway leads east back into the hall. From the southwest comes the clatter of Writing hammers and the sharp smell of burnt ink.

>get keys
Brother Horloge puts out a worn-out old hand. "Now don't you wander off with my keys," he says. "They're very important."

>x horloge
Horloge's eyes are screwed up behind the most complicated pair of spectacles I've ever encountered. They make it hard to even see his eyes - or rather what's left of them. He's read in the darkness here in the Library for so long he's basically blind. On his shoulder sits his pet owl. Same as Brother Horloge it looks more fearsome than it actually is.

By his elbow is a fat bunch of keys.

>climb shelves
They'd collapse in a moment.

>inv
I am carrying:
  my lucky clock key (being worn)
  a rag
  a tumbler

>put tumbler on shelves
The shelves are only for the holiest of texts.

Drake's clattering boots are audible to the southwest.

>e
Center Hall
I'm standing in the very centre of the Abbey's Great Hall. It's impossible not to crane my neck here, to gaze up at the ceiling held aloft by buttresses like gigantic oak trees. To think, people built this in the days before proper pulley-transmissions! It must have taken weeks! The hall continues northeast into shadow, and southwest, towards the sunlight, the Yard and above all, the Archbishop.

The vast empty space is filled by the muttering and echo of Holy Mechanisms, and the hiss of the candles as they sweep around their Tracks, providing a little light everywhere but rarely ever enough. I can just make out archways both east and west.

Drake's on patrol, and I can hear him heading this way, from the west.

* * *

>n
I can't go that way.

>ne
Library
The Abbey's library is small compared to the one in the Cathedral. There's nothing on the shelves but the key texts: the Principia, the Mechanistica and the Determininium. Only Brother Horloge, the Abbey's Primary Reader ever seems to use them - he's here at the moment, studying at his desk by the poor light coming through the stained glass windows. By his elbow is a fat bunch of keys. On his shoulder is his mechanical owl, wings folded.

An archway leads east back into the hall. From the southwest comes the clatter of Writing hammers and the sharp smell of burnt ink.

* * *

>x note
"Please leave. Needed for initiate until a cell is freed up by older brother. - Gubbler."

>read note
"Please leave. Needed for initiate until a cell is freed up by older brother. - Gubbler."

>e
Upper Hall
The Great Hall of the Abbey is the biggest room I've seen in my life, running from this end all the way southwest (and it is all the way, I'm never allowed further) to the Great Doors and the Yard outside. If I crane my neck I can see the dark square of the floorboards of my room - the ladder is on one side, to the west. Lights moves in and out overhead, from the candles moving on their Holy Tracks. Strong smells float through an archway to the east.

From their niches, the Three Major Saints are watching sternly, keen that I should get out of the Cathedral and talk to the Archbishop as quickly as possible.

* * *

>w
Library
The Abbey's library is small compared to the one in the Cathedral. There's nothing on the shelves but the key texts: the Principia, the Mechanistica and the Determininium. Only Brother Horloge, the Abbey's Primary Reader ever seems to use them - he's here at the moment, studying at his desk by the poor light coming through the stained glass windows. By his elbow is a fat bunch of keys. On his shoulder is his mechanical owl, wings folded.

An archway leads east back into the hall. From the southwest comes the clatter of Writing hammers and the sharp smell of burnt ink.

>read books
A 2nd Assistant Clock Polisher isn't even allowed to dust the Holy Texts. Besides, I only read Latin and these books are all in Mathematik.

>x books
Old leather bound tomes.

* * *

>hide inside
What do you want to hide inside?

>clock
I should polish the outside of the clock first, and that'll probably take more than long enough.

"And don't come out till that clock's shining!" shouts Drake from the hall.

"Yeah," Calvin says. "It's got to look as good as if we did it!"

"Idiot," Drake mutters. "Come on."

Their voices disappear down the hall.

>enter clock
I should polish the outside of the clock first, and that'll probably take more than long enough.

The grandfather clock ticks off a minute with a stately thunk. Quickly, I make the sign of the winding gear.

>inv
I am carrying:
  my lucky clock key (being worn)
  a rag
  a tumbler

From the hallway outside comes the echo of voices. Too shaky to be Calvin or Drake. More like - oh, no. It's the Abbot, coming back to his room. And if he finds me here, then my springs won't be worth the spindles they're sprung to…

>hide
What do you want to hide in?

>clock
"We'll talk in here," I hear the Abbot saying, from right outside the door. "More private. More quiet. Much better." The old man steps inside the room, followed by a tall figure in grey. In the last tick before his old eyes can see me, I dive inside the gigantic clock case and pull closed the door.

Inside Clock Case
As the phrase goes, I'm stuck between a rack and a gear-trace; except here I'm in the narrow gap between the clock case door and the heavy swinging penduluum behind. And if that hit me, and disrupted the holy timings… well, there's no way they wouldn't notice when the clock-hands stopped moving, let's just say.

A little light shines in through the keyhole, which is almost covered by the Abbott's spare robe.

You can also see a robe, a penduluum and two counterweights here.

The Abbot's voice is getting closer. The old man may move slower than a short hand, but he's definitely coming this way.

* * *

>x door
The clock door is smooth lacquered wood, finest quality: no knotholes or splinters here! It's covered with the usual springs and levers, and a nice gear-train motif around the keyhole.

"And don't come out till that clock's shining!" shouts Drake from the hall.

"Yeah," Calvin says. "It's got to look as good as if we did it!"

"Idiot," Drake mutters. "Come on."

Their voices disappear down the hall.

>polish door
That seems clean enough as it is.

The grandfather clock ticks off a minute with a stately thunk. Quickly, I make the sign of the winding gear.

* * *

>hide under desk
There's no need to hide right now.

"And don't come out till that clock's shining!" shouts Drake from the hall.

"Yeah," Calvin says. "It's got to look as good as if we did it!"

"Idiot," Drake mutters. "Come on."

Their voices disappear down the hall.

>look under clock
I find nothing of interest.

The grandfather clock ticks off a minute with a stately thunk. Quickly, I make the sign of the winding gear.

>jump
You jump on the spot, fruitlessly.

From the hallway outside comes the echo of voices. Too shaky to be Calvin or Drake. More like - oh, no. It's the Abbot, coming back to his room. And if he finds me here, then my springs won't be worth the spindles they're sprung to…

>w
The Abbot's voice is getting nearer… If he sees I've been in here, he'll have me turning the paddles in the laundry room for a month! There's nothing for it, I'll have to escape.

The Abbot's voice is getting closer. The old man may move slower than a short hand, but he's definitely coming this way.

* * *

>w
The Abbot's voice is getting nearer… If he sees I've been in here, he'll have me turning the paddles in the laundry room for a month! There's nothing for it, I'll have to escape.

Oh, widdershins! Gubbler is right outside the door! I'd better hide!

>hide
What do you want to hide under?

>go
You'll have to say which compass direction to go in.

That's not something you can enter.

>go
You'll have to say which compass direction to go in.

>polish
What do you want to polish?

>go
You'll have to say which compass direction to go in.

>hide
What do you want to hide under?

>go
You'll have to say which compass direction to go in.

>go
You'll have to say which compass direction to go in.

>rules
Rules tracing now switched on. Type "rules off" to switch it off again, or "rules all" to include even rules which do not apply.

>go
[Rule "block vaguely going rule" applies.]
You'll have to say which compass direction to go in.

>trace
[Trace on.]

>go
[Parsing for the verb 'go' (4 lines)]
[line 0 * -> Go]
[Line successfully parsed]
[Rule "block vaguely going rule" applies.]
You'll have to say which compass direction to go in.

>l
[Parsing for the verb 'l' (5 lines)]
[line 0 * -> Look]
[Line successfully parsed]
[Rule "determine visibility ceiling rule" applies.]
    [Rule "room description heading rule" applies.]
Abbot's Quarters
    [Rule "room description body text rule" applies.]
If I thought Abbots lived in luxury, then I was dead wrong. Even my attic's cosier than this. The Abbot's got no furniture at all, except a desk and a cot, and no decoration except for a bust of St. Newton. None of the axle-mounted bevelled mobiles I was expecting. There's barely even any sunlight: one thin window to catch the sun-rise, opposite the door to the hallway back west.

    [Rule "room description paragraphs about objects rule" applies.]
St. Newton is staring at the Abbot's unpolished Grandfather clock with a severe frown.

    [Rule "check new arrival rule" applies.]
    [Rule "other people looking rule" applies.]

>rules off
[Parsing for the verb 'rules' (3 lines)]
[line 0 * -> RulesOn]
[line 1 * 'all' -> RulesAll]
[line 2 * 'off' -> RulesOff]
[Line successfully parsed]
Rules tracing now switched off. Type "rules" to switch it on again.

>trace off
[Parsing for the verb 'trace' (4 lines)]
[line 0 * -> TraceOn]
[line 1 * number -> TraceLevel]
[line 2 * 'on' -> TraceOn]
[line 3 * 'off' -> TraceOff]
[Line successfully parsed]
Trace off.

>l
Abbot's Quarters
If I thought Abbots lived in luxury, then I was dead wrong. Even my attic's cosier than this. The Abbot's got no furniture at all, except a desk and a cot, and no decoration except for a bust of St. Newton. None of the axle-mounted bevelled mobiles I was expecting. There's barely even any sunlight: one thin window to catch the sun-rise, opposite the door to the hallway back west.

St. Newton is staring at the Abbot's unpolished Grandfather clock with a severe frown.

* * *

>hide under desk
There's no need to hide right now.

"And don't come out till that clock's shining!" shouts Drake from the hall.

"Yeah," Calvin says. "It's got to look as good as if we did it!"

"Idiot," Drake mutters. "Come on."

Their voices disappear down the hall.

>polish clock
I whisper the correct mantra against the evils of Friction and Dust, and start polishing. This'll take forever!

The grandfather clock ticks off a minute with a stately thunk. Quickly, I make the sign of the winding gear.

>polish clock face
I only understood you as far as wanting to polish Gubbler's Grandfather clock.

>x face
I can feel the well-fitted eyes of St Newton gazing right down into my workings. Quickly, I make the sign of penduluum and look away.

From the hallway outside comes the echo of voices. Too shaky to be Calvin or Drake. More like - oh, no. It's the Abbot, coming back to his room. And if he finds me here, then my springs won't be worth the spindles they're sprung to…

>hide under table
I can't see any such thing.

>hide under desk
The space under the desk is too small for me! Somewhere else, and quick!

The Abbot's voice is getting closer. The old man may move slower than a short hand, but he's definitely coming this way.

>hide under clock
There's no need to hide right now.

Oh, widdershins! Gubbler is right outside the door! I'd better hide!

>open door
(the Abbot's Door)
That's already open.

"We'll talk in here," I hear the Abbot saying, from right outside the door. "More private. More quiet. Much better." The old man steps inside the room, followed by a tall figure in grey. In the last tick before his old eyes can see me, I dive inside the gigantic clock case and pull closed the door.

Inside Clock Case
As the phrase goes, I'm stuck between a rack and a gear-trace; except here I'm in the narrow gap between the clock case door and the heavy swinging penduluum behind. And if that hit me, and disrupted the holy timings… well, there's no way they wouldn't notice when the clock-hands stopped moving, let's just say.

A little light shines in through the keyhole, which is almost covered by the Abbot's spare robe.

Oh, no… That click outside was the sound of the Abbot closing the door. Looks like he - and the grey figure I glimpsed with him - are going to be here for a while…

>ask abbot about figure
Draw attention to myself? I may be honest, but I'm not stupid. If I get kicked out of the Abbey I'll be nothing but a street urchin for the rest of a very short life.

"I told you now didn't I tell you?" old Abbot Gubbler is saying, plaintively. "Here? Why here? You shouldn't have come here."

The Figure says something in reply. I can only hear two words, but they're enough to stop my heart. "Failure," and "Consequences."

>put tumbler on door
Oh… well, then. I tip out the last of the polish onto the floor of the clock. At least that part will shine.

I put the glass tumbler carefully against the door, then lean down to press my ear against it. Fantastic! I can hear much more clearly now!

"But these things, these things are not always tick-tock, they never are," the old man replies. His voice is quivering, quite different from the steady drone he has when intoning in Chapel. "The - item you asked about - it's in the Vaults, you see? The Vaults. Even if I could get in, I …"

"Your excuses we find disappointing. Very disappointing. More of this and, Abbot, we may need to unslip your gears completely."

>z
Time passes.

The Abbot is spluttering and choking. You've seen him like this only once, when as a young initiate you dropped and smashed an altimeter right before the Archbishop was due to visit.

The Figure continues. "Clearly you're too old to steal the item for us. We have a better mechanism for obtaining it. But you must provide us with the opportunity. Is that understood?"

The Abbot nods violently, shaking out agreement the way I might beat dirt from a duster. "My money?" he asks.

* * *

>hide in crate
There's no hiding in that!

>hide under crate
There's no need to hide right now.

>d
I scramble quickly down the ladder.

Rickety Stair
I'm in one corner of the Great Hall, just by the foot of the ladder up to my room. There's a note attached to it, asking Amble the caretaker not to put it back in the shed just yet.

* * *

>x saints
The Three Major Saints examine me right back, their faces shining with Holy Precision. St Breguet, the Maker; St Newton, the Thinker; and St Babbage, the Calculatrometrist. They're only statues, of course, but they're still quite creepy here in the half-light of the moving candles.

>x st babbage
I only understood you as far as wanting to examine the statues.

>x st breguet
I only understood you as far as wanting to examine the statues.

>x st newton
I only understood you as far as wanting to examine the statues.

>x statues statues
The Three Major Saints examine me right back, their faces shining with Holy Precision. St Breguet, the Maker; St Newton, the Thinker; and St Babbage, the Calculatrometrist. They're only statues, of course, but they're still quite creepy here in the half-light of the moving candles.

Distantly - but not distantly enough - I can hear the clock and clatter of Drake's boots. The sound's coming from the east.

>x statues babbage statues
I only understood you as far as wanting to examine the statues.

>w
Rickety Stair
I'm in one corner of the Great Hall, just by the foot of the ladder up to my room. There's a note attached to it, asking Amble the caretaker not to put it back in the shed just yet.

>e
I catch the sound of hobnailed boots. Drake's heading this way! I'd better wait, and let him pass.

* * *

>x babbage statues
I can't see any such thing.

>x newton statues
The Three Major Saints examine me right back, their faces shining with Holy Precision. St Breguet, the Maker; St Newton, the Thinker; and St Babbage, the Calculatrometrist. They're only statues, of course, but they're still quite creepy here in the half-light of the moving candles.

>x statues newton
The Three Major Saints examine me right back, their faces shining with Holy Precision. St Breguet, the Maker; St Newton, the Thinker; and St Babbage, the Calculatrometrist. They're only statues, of course, but they're still quite creepy here in the half-light of the moving candles.

* * *

>hide under clock
You find nothing of interest.

"And don't come out till that clock's shining!" shouts Drake from the hall.

"Yeah," Calvin says. "It's got to look as good as if we did it!"

"Idiot," Drake mutters. "Come on."

Their voices disappear down the hall.

>w
Curses to counterweights! It's not on my rota, this clock, so why should I finish off my polish on it? I head for the doorway - then freeze. Voices, coming down the hall. It's the Abbot himself, coming this way!

>hide under desk
You find nothing of interest.

The space under the cot is too small for me! Somewhere else, and quick!

The Abbot's voice is getting closer. The old man may move slower than a short hand, but he's definitely coming this way.

>undo
Abbot's Quarters
[Previous turn undone.]

* * *

>rules
Rules tracing now switched on. Type "rules off" to switch it off again, or "rules all" to include even rules which do not apply.

>hide under desk
[Rule "Carry out hiding under" applies.]
    [Rule "standard looking under rule" applies.]
You find nothing of interest.

    [Rule "After looking under the desk" applies.]
The space under the cot is too small for me! Somewhere else, and quick!

[Rule "Every turn when the number of entries in the current script is not 0" applies.]
[Rule "Rule for firing a scripted event ( called x )" applies.]
The Abbot's voice is getting closer. The old man may move slower than a short hand, but he's definitely coming this way.

* * *

>z
Time passes.

"And don't come out till that clock's shining!" shouts Drake from the hall.

"Yeah," Calvin says. "It's got to look as good as if we did it!"

"Idiot," Drake mutters. "Come on."

Their voices disappear down the hall.

>z
Time passes.

The grandfather clock ticks off a minute with a stately thunk. Quickly, I make the sign of the winding gear.

>z
Time passes.

From the hallway outside comes the echo of voices. Too shaky to be Calvin or Drake. More like - oh, no. It's the Abbot, coming back to his room. And if he finds me here, then my springs won't be worth the spindles they're sprung to…

>z
Time passes.

The Abbot's voice is getting closer. The old man may move slower than a short hand, but he's definitely coming this way.

>z
Time passes.

Oh, widdershins! Gubbler is right outside the door! I'd better hide!

>z
Time passes.

"We'll talk in here," I hear the Abbot saying, from right outside the door. "More private. More quiet. Much better." The old man steps inside the room, followed by a tall figure in grey. In the last tick before his old eyes can see me, I dive inside the gigantic clock case and pull closed the door.

Inside Clock Case
As the phrase goes, I'm stuck between a rack and a gear-trace; except here I'm in the narrow gap between the clock case door and the heavy swinging penduluum behind. And if that hit me, and disrupted the holy timings… well, there's no way they wouldn't notice when the clock-hands stopped moving, let's just say.

A little light shines in through the keyhole, which is almost covered by the Abbott's spare robe.

>inv
I am carrying:
  my lucky clock key (being worn)
  a rag
  a tumbler

>x tumbler
A small glass with all that's left of my daily wood polish ration. How I'm supposed to do all the rest of my chores after this I don't know, but Drake and Calvin didn't seem too worried about that.

* * *

>z
Time passes.

From the hallway outside comes the echo of voices. Too shaky to be Calvin or Drake. More like - oh, no. It's the Abbot, coming back to his room. And if he finds me here, then my springs won't be worth the spindles they're sprung to…

>enter clock
"We'll talk in here," I hear the Abbot saying, from right outside the door. "More private. More quiet. Much better." The old man steps inside the room, followed by a tall figure in grey. In the last tick before his old eyes can see me, I dive inside the gigantic clock case and pull closed the door.

Inside Clock Case
As the phrase goes, I'm stuck between a rack and a gear-trace; except here I'm in the narrow gap between the clock case door and the heavy swinging penduluum behind. And if that hit me, and disrupted the holy timings… well, there's no way they wouldn't notice when the clock-hands stopped moving, let's just say.

A little light shines in through the keyhole, which is almost covered by the Abbot's spare robe.

Oh, no… That click outside was the sound of the Abbot closing the door. Looks like he - and the grey figure I glimpsed with him - are going to be here for a while…

* * *

>z
Time passes.

"I told you now didn't I tell you?" old Abbot Gubbler is saying, plaintively. "Here? Why here? You shouldn't have come here."

The Figure says something in reply. I can only hear two words, but they're enough to stop my heart. "Failure," and "Consequences."

>undo
Inside Clock Case
[Previous turn undone.]

>listen with tumbler at keyhole
Oh… well, then. I tip out the last of the polish onto the floor of the clock. At least that part will shine.

I put the glass tumbler carefully against the door, then lean down to press my ear against it. Fantastic! I can hear much more clearly now!

"I told you now didn't I tell you?" old Abbot Gubbler is saying, plaintively. "Here? Why here? You shouldn't have come here."

The Figure says something in reply. With the glass, I can hear quite clearly. That was a good idea. "We have been disappointed with your failure. The cause and effect principle, Abbot. Such failure must bring consequences."

>undo
Inside Clock Case
[Previous turn undone.]

>listen at keyhole
I put one ear to the keyhole but the Figure's voice is still too faint. But that's right and proper, isn't it? I shouldn't be eavesdropping on the Abbot's private conferences! I'd better just wait till he goes.

"I told you now didn't I tell you?" old Abbot Gubbler is saying, plaintively. "Here? Why here? You shouldn't have come here."

The Figure says something in reply. I can only hear two words, but they're enough to stop my heart. "Failure," and "Consequences."

>listen at keyhole with tumbler
Oh… well, then. I tip out the last of the polish onto the floor of the clock. At least that part will shine.

I put the glass tumbler carefully against the door, then lean down to press my ear against it. Fantastic! I can hear much more clearly now!

"But these things, these things are not always tick-tock, they never are," the old man replies. His voice is quivering, quite different from the steady drone he has when intoning in Chapel. "The - item you asked about - it's in the Vaults, you see? The Vaults. Even if I could get in, I …"

"Your excuses we find disappointing. Very disappointing. More of this and, Abbot, we may need to unslip your gears completely."

>listen at keyhole with tumbler
The tumbler is already fast against the door.

The Abbot is spluttering and choking. You've seen him like this only once, when as a young initiate you dropped and smashed an altimeter right before the Archbishop was due to visit.

The Figure continues. "Clearly you're too old to steal the item for us. We have a better mechanism for obtaining it. But you must provide us with the opportunity. Is that understood?"

The Abbot nods violently, shaking out agreement the way I might beat dirt from a duster. "My money?" he asks.

>x aboot
I can't see any such thing.

>x abott
I can't see any such thing.

>x abbot
No wonder Calvin and Drake didn't want to do this. Abbot Gubbler's Grandfather clock is enormous: the face is the size of a dinnerplate and the cabinet below is big enough to be a wardrobe. Even just polishing the doors will take half an hour. The whole thing might take all day.

There's the clink, of a pouch of golden minutes. A heavy pouch. The Figure, paying the Abbot…? Then suddenly, there's a third voice. "Sorry, Father, to interrupt, but you said…"

It's a monk of the Abbey. "Get out!" the Abbot screeches. His bearing's lost its oil, it seems. "Get out, get out!"

"But Father," the monk continues, "it's time, you know. You told me to tell you when it was time."

"Oh! Of course of course," he mumbles. "I'll… We'll continue this discussion later, then," he says, to the Figure.

"We certainly will," the Figure replies.

The Abbot leaves, and that leaves me alone, inside this clock, with the stranger outside. He's coming nearer… I can hear his fingers on the door of the case! I must have nudged the penduluum, he must have seen the clock-hands quiver… but then, there's the swish of his cloak as he moves away, and the click as the door closes. Phew.

* * *

>z
Time passes.

The grandfather clock ticks off a minute with a stately thunk. Quickly, I make the sign of the winding gear.

>enter clock
I should polish the outside of the clock first, and that'll probably take more than long enough.

From the hallway outside comes the echo of voices. Too shaky to be Calvin or Drake. More like - oh, no. It's the Abbot, coming back to his room. And if he finds me here, then my springs won't be worth the spindles they're sprung to…

* * *

>undo
Abbot's Quarters
[Previous turn undone.]

>z
Time passes.

The Abbot's voice is getting closer. The old man may move slower than a short hand, but he's definitely coming this way.

* * *

>z
Time passes.

Oh, widdershins! Gubbler is right outside the door! I'd better hide!

>z
Time passes.

"We'll talk in here," I hear the Abbot saying, from right outside the door. "More private. More quiet. Much better." The old man steps inside the room, followed by a tall figure in grey. In the last tick before his old eyes can see me, I dive inside the gigantic clock case and pull closed the door.

Inside Clock Case
As the phrase goes, I'm stuck between a rack and a gear-trace; except here I'm in the narrow gap between the clock case door and the heavy swinging penduluum behind. And if that hit me, and disrupted the holy timings… well, there's no way they wouldn't notice when the clock-hands stopped moving, let's just say.

A little light shines in through the keyhole, which is almost covered by the Abbot's spare robe.

Oh, no… That click outside was the sound of the Abbot closing the door. Looks like he - and the grey figure I glimpsed with him - are going to be here for a while…

>x robe
It's a thick black woollen habit, with a long deep hood and sleeves big enough to fit a five-and-a-quarter transmission with room to spare. Being the Abbot's robe means it has a softer lining, and a little sewn-in pocket for his tissues, spectacles, and that sort of thing.

"I told you now didn't I tell you?" old Abbot Gubbler is saying, plaintively. "Here? Why here? You shouldn't have come here."

The Figure says something in reply. I can only hear two words, but they're enough to stop my heart. "Failure," and "Consequences."

>listen at door
I hear nothing unexpected.

"But these things, these things are not always tick-tock, they never are," the old man replies. His voice is quivering, quite different from the steady drone he has when intoning in Chapel. "The - item you asked about - it's in the Vaults, you see? The Vaults. Even if I could get in, I …"

The Figure is too far from the keyhole and speaks too quietly for me to hear clearly. "Disappointing," he says; and then "unslip your gears."

>listen at door with tumbler
Oh… well, then. I tip out the last of the polish onto the floor of the clock. At least that part will shine.

I put the glass tumbler carefully against the door, then lean down to press my ear against it. Fantastic! I can hear much more clearly now!

The Abbot is spluttering and choking. You've seen him like this only once, when as a young initiate you dropped and smashed an altimeter right before the Archbishop was due to visit.

The Figure continues. "Clearly you're too old to steal the item for us. We have a better mechanism for obtaining it. But you must provide us with the opportunity. Is that understood?"

The Abbot nods violently, shaking out agreement the way I might beat dirt from a duster. "My money?" he asks.

>look
Inside Clock Case
I'm leaning up against the door of the clock, with my ear pressed against the glass tumbler. The penduluum behind is like someone breathing in my ear. If I'm caught in here, I'm dead.

A little light shines in through the keyhole, which is almost covered by the Abbot's spare robe.

There's the clink, of a pouch of golden minutes. A heavy pouch. The Figure, paying the Abbot…? Then suddenly, there's a third voice. "Sorry, Father, to interrupt, but you said…"

It's a monk of the Abbey. "Get out!" the Abbot screeches. His bearing's lost its oil, it seems. "Get out, get out!"

"But Father," the monk continues, "it's time, you know. You told me to tell you when it was time."

"Oh! Of course of course," he mumbles. "I'll… We'll continue this discussion later, then," he says, to the Figure.

"We certainly will," the Figure replies.

The Abbot leaves, and that leaves me alone, inside this clock, with the stranger outside. He's coming nearer… I can hear his fingers on the door of the case! I must have nudged the penduluum, he must have seen the clock-hands quiver… but then, there's the swish of his cloak as he moves away, and the click as the door closes. Phew.

>listen to keyhole
I put one ear to the keyhole but the Figure's voice is still too faint. But that's right and proper, isn't it? I shouldn't be eavesdropping on the Abbot's private conferences! I'd better just wait till he goes.

>look through keyhole
I find nothing of interest.

>x keyhole
Through the keyhole I can see the corner of the Abbot's desk, but the Abbot and the Figure have gone.

>search keyhole
I find nothing of interest.

* * *

>z
Time passes.

"And don't come out till that clock's shining!" shouts Drake from the hall.

"Yeah," Calvin says. "It's got to look as good as if we did it!"

"Idiot," Drake mutters. "Come on."

Their voices disappear down the hall.

>scenes
Scene 'Entire Game' playing (for 1 mins now)
Scene 'Introduction' playing (for 1 mins now)
(Scene monitoring now switched on. Type "scenes off" to switch it off again.)

>z
Time passes.

The grandfather clock ticks off a minute with a stately thunk. Quickly, I make the sign of the winding gear.

* * *

>z
Time passes.

From the hallway outside comes the echo of voices. Too shaky to be Calvin or Drake. More like - oh, no. It's the Abbot, coming back to his room. And if he finds me here, then my springs won't be worth the spindles they're sprung to…

>enter clock
"We'll talk in here," I hear the Abbot saying, from right outside the door. "More private. More quiet. Much better." The old man steps inside the room, followed by a tall figure in grey. In the last tick before his old eyes can see me, I dive inside the gigantic clock case and pull closed the door.

Inside Clock Case
As the phrase goes, I'm stuck between a rack and a gear-trace; except here I'm in the narrow gap between the clock case door and the heavy swinging penduluum behind. And if that hit me, and disrupted the holy timings… well, there's no way they wouldn't notice when the clock-hands stopped moving, let's just say.

A little light shines in through the keyhole, which is almost covered by the Abbot's spare robe.

>z
Time passes.

>l
Inside Clock Case
As the phrase goes, I'm stuck between a rack and a gear-trace; except here I'm in the narrow gap between the clock case door and the heavy swinging penduluum behind. And if that hit me, and disrupted the holy timings… well, there's no way they wouldn't notice when the clock-hands stopped moving, let's just say.

A little light shines in through the keyhole, which is almost covered by the Abbot's spare robe.

>out
I can't, since Gubbler's Grandfather clock is in the way.

>open clock
I open Gubbler's Grandfather clock.

>out
Abbot's Quarters
If I thought Abbots lived in luxury, then I was dead wrong. Even my attic's cosier than this. The Abbot's got no furniture at all, except a desk and a cot, and no decoration except for a bust of St. Newton. None of the axle-mounted bevelled mobiles I was expecting. There's barely even any sunlight: one thin window to catch the sun-rise, opposite the door to the hallway back west.

St. Newton is staring at the Abbot's unpolished Grandfather clock with a severe frown.

>in
Inside Clock Case
As the phrase goes, I'm stuck between a rack and a gear-trace; except here I'm in the narrow gap between the clock case door and the heavy swinging penduluum behind. And if that hit me, and disrupted the holy timings… well, there's no way they wouldn't notice when the clock-hands stopped moving, let's just say.

A little light shines in through the keyhole, which is almost covered by the Abbot's spare robe.

>scenes
Scene 'Entire Game' playing (for 10 mins now)
Scene 'Introduction' playing (for 10 mins now)
(Scene monitoring now switched on. Type "scenes off" to switch it off again.)

* * *

>listen with tumbler
"And don't come out till that clock's shining!" shouts Drake from the hall.

"Yeah," Calvin says. "It's got to look as good as if we did it!"

"Idiot," Drake mutters. "Come on."

Their voices disappear down the hall.

* * *

>empty polish
That doesn't contain anything
"And don't come out till that clock's shining!" shouts Drake from the hall.

"Yeah," Calvin says. "It's got to look as good as if we did it!"

"Idiot," Drake mutters. "Come on."

Their voices disappear down the hall.

>pour away tumbler
Emptied.

The grandfather clock ticks off a minute with a stately thunk. Quickly, I make the sign of the winding gear.

>l
Abbot's Quarters
If I thought Abbots lived in luxury, then I was dead wrong. Even my attic's cosier than this. The Abbot's got no furniture at all, except a desk and a cot, and no decoration except for a bust of St. Newton. None of the axle-mounted bevelled mobiles I was expecting. There's barely even any sunlight: one thin window to catch the sun-rise, opposite the door to the hallway back west.

St. Newton is staring at the Abbot's unpolished Grandfather clock with a severe frown.

I can also see a small amount of polish here.

From the hallway outside comes the echo of voices. Too shaky to be Calvin or Drake. More like - oh, no. It's the Abbot, coming back to his room. And if he finds me here, then my springs won't be worth the spindles they're sprung to…

>put polish in tumbler
I need to be holding the small amount of polish before I can put it into something else.

The Abbot's voice is getting closer. The old man may move slower than a short hand, but he's definitely coming this way.

* * *

>empty tumbler
I'll need to save every last drop. There's twenty more clocks to do today at least!

"And don't come out till that clock's shining!" shouts Drake from the hall.

"Yeah," Calvin says. "It's got to look as good as if we did it!"

"Idiot," Drake mutters. "Come on."

Their voices disappear down the hall.

>inv
I am carrying:
  my lucky clock key (being worn)
  a rag
  a tumbler

The grandfather clock ticks off a minute with a stately thunk. Quickly, I make the sign of the winding gear.

* * *

>empty tumbler
I'll need to save every last drop. There's twenty more clocks to do today at least!

"And don't come out till that clock's shining!" shouts Drake from the hall.

"Yeah," Calvin says. "It's got to look as good as if we did it!"

"Idiot," Drake mutters. "Come on."

Their voices disappear down the hall.

>undo
Abbot's Quarters
[Previous turn undone.]

* * *

>empty tumbler
I'll need to save every last drop. There's twenty more clocks to do today at least!

"And don't come out till that clock's shining!" shouts Drake from the hall.

"Yeah," Calvin says. "It's got to look as good as if we did it!"

"Idiot," Drake mutters. "Come on."

Their voices disappear down the hall.

>hide in clock
I should polish the outside of the clock first, and that'll probably take more than long enough.

The grandfather clock ticks off a minute with a stately thunk. Quickly, I make the sign of the winding gear.

>z
Time passes.

From the hallway outside comes the echo of voices. Too shaky to be Calvin or Drake. More like - oh, no. It's the Abbot, coming back to his room. And if he finds me here, then my springs won't be worth the spindles they're sprung to…

>hide in clock
"We'll talk in here," I hear the Abbot saying, from right outside the door. "More private. More quiet. Much better." The old man steps inside the room, followed by a tall figure in grey. In the last tick before his old eyes can see me, I dive inside the gigantic clock case and pull closed the door.

Inside Clock Case
As the phrase goes, I'm stuck between a rack and a gear-trace; except here I'm in the narrow gap between the clock case door and the heavy swinging penduluum behind. And if that hit me, and disrupted the holy timings… well, there's no way they wouldn't notice when the clock-hands stopped moving, let's just say.

A little light shines in through the keyhole, which is almost covered by the Abbot's spare robe.

Oh, no… That click outside was the sound of the Abbot closing the door. Looks like he - and the grey figure I glimpsed with him - are going to be here for a while…

>empty tumbler
Oh… well, then. I tip out the last of the polish onto the floor of the clock. At least that part will shine.

>empty tumbler
The tumbler is empty.

>put rag in tumbler
Done.

>empty tumbler
I pour the rag onto the floor.

>get rag
Taken.

* * *

>put rag in polish
That can't contain things.

"And don't come out till that clock's shining!" shouts Drake from the hall.

"Yeah," Calvin says. "It's got to look as good as if we did it!"

"Idiot," Drake mutters. "Come on."

Their voices disappear down the hall.

>put rag in tumbler
Done.

The grandfather clock ticks off a minute with a stately thunk. Quickly, I make the sign of the winding gear.

>empty rumbler
I can't see any such thing.

>empty tumbler
I'll need to save every last drop. There's twenty more clocks to do today at least!

From the hallway outside comes the echo of voices. Too shaky to be Calvin or Drake. More like - oh, no. It's the Abbot, coming back to his room. And if he finds me here, then my springs won't be worth the spindles they're sprung to…

>get rag
Taken.

The Abbot's voice is getting closer. The old man may move slower than a short hand, but he's definitely coming this way.

>hide in clock
"We'll talk in here," I hear the Abbot saying, from right outside the door. "More private. More quiet. Much better." The old man steps inside the room, followed by a tall figure in grey. In the last tick before his old eyes can see me, I dive inside the gigantic clock case and pull closed the door.

Inside Clock Case
As the phrase goes, I'm stuck between a rack and a gear-trace; except here I'm in the narrow gap between the clock case door and the heavy swinging penduluum behind. And if that hit me, and disrupted the holy timings… well, there's no way they wouldn't notice when the clock-hands stopped moving, let's just say.

A little light shines in through the keyhole, which is almost covered by the Abbot's spare robe.

Oh, no… That click outside was the sound of the Abbot closing the door. Looks like he - and the grey figure I glimpsed with him - are going to be here for a while…

* * *

>empty tumbler
Oh… well, then. I tip out the last of the polish onto the floor of the clock. At least that part will shine.

>inv
I am carrying:
  a rag
  my lucky clock key (being worn)
  a tumbler

>put rag in tumber
I can't see any such thing.

>put rag in tumbler
Done.

>empty tumbler
Oh… well, then. I tip out the last of the polish onto the floor of the clock. At least that part will shine.

>l
Inside Clock Case
As the phrase goes, I'm stuck between a rack and a gear-trace; except here I'm in the narrow gap between the clock case door and the heavy swinging penduluum behind. And if that hit me, and disrupted the holy timings… well, there's no way they wouldn't notice when the clock-hands stopped moving, let's just say.

A little light shines in through the keyhole, which is almost covered by the Abbot's spare robe.

I can also see a rag here.

>get rag
Taken.

* * *

>enter case
I can't see any such thing.

>enter clock
I should polish the outside of the clock first, and that'll probably take more than long enough.

"And don't come out till that clock's shining!" shouts Drake from the hall.

"Yeah," Calvin says. "It's got to look as good as if we did it!"

"Idiot," Drake mutters. "Come on."

Their voices disappear down the hall.

* * *

>z
Time passes.

Oh, widdershins! Gubbler is right outside the door! I'd better hide!

>enter clock
"We'll talk in here," I hear the Abbot saying, from right outside the door. "More private. More quiet. Much better." The old man steps inside the room, followed by a tall figure in grey. In the last tick before his old eyes can see me, I dive inside the gigantic clock case and pull closed the door.

Inside Clock Case
As the phrase goes, I'm stuck between a rack and a gear-trace; except here I'm in the narrow gap between the clock case door and the heavy swinging penduluum behind. And if that hit me, and disrupted the holy timings… well, there's no way they wouldn't notice when the clock-hands stopped moving, let's just say.

A little light shines in through the keyhole, which is almost covered by the Abbot's spare robe.

Oh, no… That click outside was the sound of the Abbot closing the door. Looks like he - and the grey figure I glimpsed with him - are going to be here for a while…

* * *

>undo
Abbot's Quarters
[Previous turn undone.]

>z
Time passes.

"We'll talk in here," I hear the Abbot saying, from right outside the door. "More private. More quiet. Much better." The old man steps inside the room, followed by a tall figure in grey. In the last tick before his old eyes can see me, I dive inside the gigantic clock case and pull closed the door.

Inside Clock Case
As the phrase goes, I'm stuck between a rack and a gear-trace; except here I'm in the narrow gap between the clock case door and the heavy swinging penduluum behind. And if that hit me, and disrupted the holy timings… well, there's no way they wouldn't notice when the clock-hands stopped moving, let's just say.

A little light shines in through the keyhole, which is almost covered by the Abbot's spare robe.

>z
Time passes.

>script
Attempt to begin transcript failed.

>events
{}

* * *

>exit
But I am not in anything at the moment.

"And don't come out till that clock's shining!" shouts Drake from the hall.

"Yeah," Calvin says. "It's got to look as good as if we did it!"

"Idiot," Drake mutters. "Come on."

Their voices disappear down the hall.

>leave clock
I should polish the outside of the clock first, and that'll probably take more than long enough.

The grandfather clock ticks off a minute with a stately thunk. Quickly, I make the sign of the winding gear.

>enter clock
I should polish the outside of the clock first, and that'll probably take more than long enough.

From the hallway outside comes the echo of voices. Too shaky to be Calvin or Drake. More like - oh, no. It's the Abbot, coming back to his room. And if he finds me here, then my springs won't be worth the spindles they're sprung to…

* * *

>enter clock
You've got a spring missing if you think I can slip out, unnoticed, or come up with a decent excuse as to why I've been hiding in the Abbot's grandfather. No, I'm staying put and hoping nothing happens to make the old man need to change his clothes.

"I told you now didn't I tell you?" old Abbot Gubbler is saying, plaintively. "Here? Why here? You shouldn't have come here."

The Figure says something in reply. I can only hear two words, but they're enough to stop my heart. "Failure," and "Consequences."

>out
You've got a spring missing if you think I can slip out, unnoticed, or come up with a decent excuse as to why I've been hiding in the Abbot's grandfather. No, I'm staying put and hoping nothing happens to make the old man need to change his clothes.

"But these things, these things are not always tick-tock, they never are," the old man replies. His voice is quivering, quite different from the steady drone he has when intoning in Chapel. "The - item you asked about - it's in the Vaults, you see? The Vaults. Even if I could get in, I …"

The Figure is too far from the keyhole and speaks too quietly for me to hear clearly. "Disappointing," he says; and then "unslip your gears."

>exit
You've got a spring missing if you think I can slip out, unnoticed, or come up with a decent excuse as to why I've been hiding in the Abbot's grandfather. No, I'm staying put and hoping nothing happens to make the old man need to change his clothes.

The Abbot is spluttering and choking. You've seen him like this only once, when as a young initiate you dropped and smashed an altimeter right before the Archbishop was due to visit.

The Figure's quiet voice continues. I can make out; "too old to steal", "a better mechanism", "the opportunity."

The Abbot nods violently, shaking out agreement the way I might beat dirt from a duster. "My money?" he asks.

>leave
You'll have to say which compass direction to go in.
 
There's the clink, of a pouch of golden minutes. A heavy pouch. The Figure, paying the Abbot…? Then suddenly, there's a third voice. "Sorry, Father, to interrupt, but you said…"

It's a monk of the Abbey. "Get out!" the Abbot screeches. His bearing's lost its oil, it seems. "Get out, get out!"

"But Father," the monk continues, "it's time, you know. You told me to tell you when it was time."

"Oh! Of course of course," he mumbles. "I'll… We'll continue this discussion later, then," he says, to the Figure.

The Figure intones something in reply.

The Abbot leaves, and that leaves me alone, inside this clock, with the stranger outside. He's coming nearer… I can hear his fingers on the door of the case! I must have nudged the penduluum, he must have seen the clock-hands quiver… but then, there's the swish of his cloak as he moves away, and the click as the door closes. Phew.

>out
I open Gubbler's Grandfather clock.

I spill gratefully out of the clock, gasping for breath as though I've been underwater. I've just been holding it in, of course. As what I've heard - well, I probably shouldn't have, and the quicker I can get out of here, the better.

Abbot's Quarters
If I thought Abbots lived in luxury, then I was dead wrong. Even my attic's cosier than this. The Abbot's got no furniture at all, except a desk and a cot, and no decoration except for a bust of St. Newton. None of the axle-mounted bevelled mobiles I was expecting. There's barely even any sunlight: one thin window to catch the sun-rise, opposite the door to the hallway back west.

St. Newton is staring at the Abbot's unpolished Grandfather clock with a severe frown.

>look in clock
For a big clock it's got a pretty small penduluum, about the size of Calvin's fist and not as big as Drake's. There's even enough space in front of it for the Abbot to hang up one of his spare robes.

>x spare robe
I can't see any such thing.

>w
I'm going to have to tell someone what I just heard. A theft, from the Vaults! But if the Abbot's involved - then who else might be? After all, the figure he was talking to could have been anyone in the Abbey!

* * *

>e
I can't go that way.

"And don't come out till that clock's shining!" shouts Drake from the hall.

"Yeah," Calvin says. "It's got to look as good as if we did it!"

"Idiot," Drake mutters. "Come on."

Their voices disappear down the hall.

>rules
Rules tracing now switched on. Type "rules off" to switch it off again, or "rules all" to include even rules which do not apply.

>e
[Rule "standard set going variables rule" applies.]
    [Rule "can't travel in what's not a vehicle rule" applies.]
    [Rule "can't go through undescribed doors rule" applies.]
    [Rule "can't go through closed doors rule" applies.]
I can't, since the barred window is in the way.

[Rule "Every turn when the number of entries in the current script is not 0" applies.]
[Rule "Rule for firing a scripted event ( called x )" applies.]
The grandfather clock ticks off a minute with a stately thunk. Quickly, I make the sign of the winding gear.

* * *

>e
I can't go that way.

"And don't come out till that clock's shining!" shouts Drake from the hall.

"Yeah," Calvin says. "It's got to look as good as if we did it!"

"Idiot," Drake mutters. "Come on."

Their voices disappear down the hall.

>enter window
The bars are too narrow to slip through, and too firm to break.

The grandfather clock ticks off a minute with a stately thunk. Quickly, I make the sign of the winding gear.

>rules
Rules tracing now switched on. Type "rules off" to switch it off again, or "rules all" to include even rules which do not apply.

>enter window
[Rule "convert enter door into go rule" applies.]
    [Rule "standard set going variables rule" applies.]
    [Rule "can't travel in what's not a vehicle rule" applies.]
    [Rule "can't go through undescribed doors rule" applies.]
    [Rule "can't go through closed doors rule" applies.]
    [Rule "determine map connection rule" applies.]
    [Rule "can't go that way rule" applies.]
I can't, since the barred window leads nowhere.

[Rule "Every turn when the number of entries in the current script is not 0" applies.]
[Rule "Rule for firing a scripted event ( called x )" applies.]
From the hallway outside comes the echo of voices. Too shaky to be Calvin or Drake. More like - oh, no. It's the Abbot, coming back to his room. And if he finds me here, then my springs won't be worth the spindles they're sprung to…

* * *

>enter window
The bars are too narrow to slip through, and too firm to break.

The grandfather clock ticks off a minute with a stately thunk. Quickly, I make the sign of the winding gear.

>go through window
The bars are too narrow to slip through, and too firm to break.

From the hallway outside comes the echo of voices. Too shaky to be Calvin or Drake. More like - oh, no. It's the Abbot, coming back to his room. And if he finds me here, then my springs won't be worth the spindles they're sprung to…

>climb through window
The bars are too narrow to slip through, and too firm to break.

The Abbot's voice is getting closer. The old man may move slower than a short hand, but he's definitely coming this way.

>climb through clock
I don't think much is to be achieved by that.

Oh, widdershins! Gubbler is right outside the door! I'd better hide!

>enter clock
"We'll talk in here," I hear the Abbot saying, from right outside the door. "More private. More quiet. Much better." The old man steps inside the room, followed by a tall figure in grey. In the last tick before his old eyes can see me, I dive inside the gigantic clock case and pull closed the door.

Inside Clock Case
As the phrase goes, I'm stuck between a rack and a gear-trace; except here I'm in the narrow gap between the clock case door and the heavy swinging penduluum behind. And if that hit me, and disrupted the holy timings… well, there's no way they wouldn't notice when the clock-hands stopped moving, let's just say.

A little light shines in through the keyhole, which is almost covered by the Abbot's spare robe.

Oh, no… That click outside was the sound of the Abbot closing the door. Looks like he - and the grey figure I glimpsed with him - are going to be here for a while…

* * *

>e
I can't go that way.

"And don't come out till that clock's shining!" shouts Drake from the hall.

"Yeah," Calvin says. "It's got to look as good as if we did it!"

"Idiot," Drake mutters. "Come on."

Their voices disappear down the hall.

>w
Curses to counterweights! It's not on my rota, this clock, so why should I finish off my polish on it? I head for the doorway - then freeze. Voices, coming down the hall. It's the Abbot himself, coming this way!

>enter abbot's door
The Abbot's voice is getting nearer… If he sees I've been in here, he'll have me turning the paddles in the laundry room for a month! There's nothing for it, I'll have to escape.

The Abbot's voice is getting closer. The old man may move slower than a short hand, but he's definitely coming this way.

>enter window
The bars are too narrow to slip through, and too firm to break.

Oh, widdershins! Gubbler is right outside the door! I'd better hide!

>enter clock
"We'll talk in here," I hear the Abbot saying, from right outside the door. "More private. More quiet. Much better." The old man steps inside the room, followed by a tall figure in grey. In the last tick before his old eyes can see me, I dive inside the gigantic clock case and pull closed the door.

Inside Clock Case
As the phrase goes, I'm stuck between a rack and a gear-trace; except here I'm in the narrow gap between the clock case door and the heavy swinging penduluum behind. And if that hit me, and disrupted the holy timings… well, there's no way they wouldn't notice when the clock-hands stopped moving, let's just say.

A little light shines in through the keyhole, which is almost covered by the Abbot's spare robe.

Oh, no… That click outside was the sound of the Abbot closing the door. Looks like he - and the grey figure I glimpsed with him - are going to be here for a while…

* * *

>undo
Inside Clock Case
[Previous turn undone.]

>listen with tumbler
Oh… well, then. I tip out the last of the polish onto the floor of the clock. At least that part will shine.

I put the glass tumbler carefully against the door, then lean down to press my ear against it. Fantastic! I can hear much more clearly now!

"I told you now didn't I tell you?" old Abbot Gubbler is saying, plaintively. "Here? Why here? You shouldn't have come here."

The Figure says something in reply. With the glass, I can hear quite clearly. That was a good idea. "We have been disappointed with your failure. The cause and effect principle, Abbot. Such failure must bring consequences."

I beg your pardon?

>z
Time passes.

"But these things, these things are not always tick-tock, they never are," the old man replies. His voice is quivering, quite different from the steady drone he has when intoning in Chapel. "The - item you asked about - it's in the Vaults, you see? The Vaults. Even if I could get in, I …"

"Your excuses we find disappointing. Very disappointing. More of this and, Abbot, we may need to unslip your gears completely."

>listen
The Abbot is spluttering and choking. You've seen him like this only once, when as a young initiate you dropped and smashed an altimeter right before the Archbishop was due to visit.

The Figure continues. "Clearly you're too old to steal the item for us. We have a better mechanism for obtaining it. But you must provide us with the opportunity. Is that understood?"

The Abbot nods violently, shaking out agreement the way I might beat dirt from a duster. "My money?" he asks.

>look through keyhole
I can make out the Abbot's hands, which are shaking badly. But I can see nothing of the Figure.

There's the clink, of a pouch of golden minutes. A heavy pouch. The Figure, paying the Abbot…? Then suddenly, there's a third voice. "Sorry, Father, to interrupt, but you said…"

It's a monk of the Abbey. "Get out!" the Abbot screeches. His bearing's lost its oil, it seems. "Get out, get out!"

"But Father," the monk continues, "it's time, you know. You told me to tell you when it was time."

"Oh! Of course of course," he mumbles. "I'll… We'll continue this discussion later, then," he says, to the Figure.

"We certainly will," the Figure replies.

The Abbot leaves, and that leaves me alone, inside this clock, with the stranger outside. He's coming nearer… I can hear his fingers on the door of the case! I must have nudged the penduluum, he must have seen the clock-hands quiver… but then, there's the swish of his cloak as he moves away, and the click as the door closes. Phew.

>out
I spill gratefully out of the clock, gasping for breath as though I've been underwater. I've just been holding it in, of course. As what I've heard - well, I probably shouldn't have, and the quicker I can get out of here, the better.

Abbot's Quarters
If I thought Abbots lived in luxury, then I was dead wrong. Even my attic's cosier than this. The Abbot's got no furniture at all, except a desk and a cot, and no decoration except for a bust of St. Newton. None of the axle-mounted bevelled mobiles I was expecting. There's barely even any sunlight: one thin window to catch the sun-rise, opposite the door to the hallway back west.

St. Newton is staring at the Abbot's unpolished Grandfather clock with a severe frown.

>x keyhole
It's just a keyhole. It might be only ornamental.

>enter case
I can't see any such thing.

>enter clock
Inside Clock Case
As the phrase goes, I'm stuck between a rack and a gear-trace; except here I'm in the narrow gap between the clock case door and the heavy swinging penduluum behind. And if that hit me, and disrupted the holy timings… well, there's no way they wouldn't notice when the clock-hands stopped moving, let's just say.

A little light shines in through the keyhole, which is almost covered by the Abbot's spare robe.

>x case
I can't see any such thing.

>x me
When the monks took me, aged six months, into their care, they named me Wren. Maybe because I was small, insignificant, and happy to eat any crumbs they threw my way. But these days I'm Wren, 2nd Assistant Clock Polisher… and that's a role that's about as important in the workings of the Cathedral of Time as the large deaf man who re-stretches the worn-out springs.

>e
I can't go that way.

>w
I can't go that way.

>out
Abbot's Quarters
If I thought Abbots lived in luxury, then I was dead wrong. Even my attic's cosier than this. The Abbot's got no furniture at all, except a desk and a cot, and no decoration except for a bust of St. Newton. None of the axle-mounted bevelled mobiles I was expecting. There's barely even any sunlight: one thin window to catch the sun-rise, opposite the door to the hallway back west.

St. Newton is staring at the Abbot's unpolished Grandfather clock with a severe frown.

* * *

>in
Inside Clock Case
As the phrase goes, I'm stuck between a rack and a gear-trace; except here I'm in the narrow gap between the clock case door and the heavy swinging penduluum behind. And if that hit me, and disrupted the holy timings… well, there's no way they wouldn't notice when the clock-hands stopped moving, let's just say.

A little light shines in through the keyhole, which is almost covered by the Abbot's spare robe.

>out
Abbot's Quarters
If I thought Abbots lived in luxury, then I was dead wrong. Even my attic's cosier than this. The Abbot's got no furniture at all, except a desk and a cot, and no decoration except for a bust of St. Newton. None of the axle-mounted bevelled mobiles I was expecting. There's barely even any sunlight: one thin window to catch the sun-rise, opposite the door to the hallway back west.

St. Newton is staring at the Abbot's unpolished Grandfather clock with a severe frown.

>out
But I am not in anything at the moment.

* * *

>read note
"Please leave. Needed for initiate until a cell is freed up by older brother. - Gubbler."

>get note
I'd rather leave the sign be. Last time Amble took the ladder away guess where I was?

* * *

>enter door
(the Abbot's Door)
I'm not staying here. I walk straight out again… but Drake's waiting to push me back.

"Polish the clock, loose-screw!" he clangs. "And don't come out till it's shining!"

"Yeah," Calvin says. "It's got to look as good as if we did it!"

"Idiot," Drake mutters. "Come on."

Their voices disappear down the hall.

>enter door
(the Abbot's Door)
Curses to counterweights! It's not on my rota, this clock, so why should I finish off my polish on it? I head for the doorway - then freeze. Voices, coming down the hall. It's the Abbot himself, coming this way!

>enter door
(the Abbot's Door)
The Abbot's voice is getting nearer… If he sees I've been in here, he'll have me turning the paddles in the laundry room for a month! There's nothing for it, I'll have to escape.

The Abbot's voice is getting closer. The old man may move slower than a short hand, but he's definitely coming this way.

>enter clock
"We'll talk in here," I hear the Abbot saying, from right outside the door. "More private. More quiet. Much better." The old man steps inside the room, followed by a tall figure in grey. In the last tick before his old eyes can see me, I dive inside the gigantic clock case and pull closed the door.

Inside Clock Case
As the phrase goes, I'm stuck between a rack and a gear-trace; except here I'm in the narrow gap between the clock case door and the heavy swinging penduluum behind. And if that hit me, and disrupted the holy timings… well, there's no way they wouldn't notice when the clock-hands stopped moving, let's just say.

A little light shines in through the keyhole, which is almost covered by the Abbot's spare robe.

Oh, no… That click outside was the sound of the Abbot closing the door. Looks like he - and the grey figure I glimpsed with him - are going to be here for a while…

* * *

>enter clock
You've got a spring missing if you think I can slip out, unnoticed, or come up with a decent excuse as to why I've been hiding in the Abbot's grandfather. No, I'm staying put and hoping nothing happens to make the old man need to change his clothes.

"I told you now didn't I tell you?" old Abbot Gubbler is saying, plaintively. "Here? Why here? You shouldn't have come here."

The Figure says something in reply. I can only hear two words, but they're enough to stop my heart. "Failure," and "Consequences."

>listen with tumbler
Oh… well, then. I tip out the last of the polish onto the floor of the clock. At least that part will shine.

I put the glass tumbler carefully against the door, then lean down to press my ear against it. Fantastic! I can hear much more clearly now!

"But these things, these things are not always tick-tock, they never are," the old man replies. His voice is quivering, quite different from the steady drone he has when intoning in Chapel. "The - item you asked about - it's in the Vaults, you see? The Vaults. Even if I could get in, I …"

"Your excuses we find disappointing. Very disappointing. More of this and, Abbot, we may need to unslip your gears completely."

>listen with tumbler at door
Oh… well, then. I tip out the last of the polish onto the floor of the clock. At least that part will shine.

I put the glass tumbler carefully against the door, then lean down to press my ear against it. Fantastic! I can hear much more clearly now!

The Abbot is spluttering and choking. You've seen him like this only once, when as a young initiate you dropped and smashed an altimeter right before the Archbishop was due to visit.

The Figure continues. "Clearly you're too old to steal the item for us. We have a better mechanism for obtaining it. But you must provide us with the opportunity. Is that understood?"

The Abbot nods violently, shaking out agreement the way I might beat dirt from a duster. "My money?" he asks.

* * *

>listen with tumbler
The tumbler is already fast against the door.

The Abbot is spluttering and choking. You've seen him like this only once, when as a young initiate you dropped and smashed an altimeter right before the Archbishop was due to visit.

The Figure continues. "Clearly you're too old to steal the item for us. We have a better mechanism for obtaining it. But you must provide us with the opportunity. Is that understood?"

The Abbot nods violently, shaking out agreement the way I might beat dirt from a duster. "My money?" he asks.

>listen
There's the clink, of a pouch of golden minutes. A heavy pouch. The Figure, paying the Abbot…? Then suddenly, there's a third voice. "Sorry, Father, to interrupt, but you said…"

It's a monk of the Abbey. "Get out!" the Abbot screeches. His bearing's lost its oil, it seems. "Get out, get out!"

"But Father," the monk continues, "it's time, you know. You told me to tell you when it was time."

"Oh! Of course of course," he mumbles. "I'll… We'll continue this discussion later, then," he says, to the Figure.

"We certainly will," the Figure replies.

The Abbot leaves, and that leaves me alone, inside this clock, with the stranger outside. He's coming nearer… I can hear his fingers on the door of the case! I must have nudged the penduluum, he must have seen the clock-hands quiver… but then, there's the swish of his cloak as he moves away, and the click as the door closes. Phew.

>go through door
I spill gratefully out of the clock, gasping for breath as though I've been underwater. I've just been holding it in, of course. As what I've heard - well, I probably shouldn't have, and the quicker I can get out of here, the better.

Abbot's Quarters
If I thought Abbots lived in luxury, then I was dead wrong. Even my attic's cosier than this. The Abbot's got no furniture at all, except a desk and a cot, and no decoration except for a bust of St. Newton. None of the axle-mounted bevelled mobiles I was expecting. There's barely even any sunlight: one thin window to catch the sun-rise, opposite the door to the hallway back west.

St. Newton is staring at the Abbot's unpolished Grandfather clock with a severe frown.

>close clock
I close Gubbler's Grandfather clock.

>w
(first opening the Abbot's Door)
I'm going to have to tell someone what I just heard. A theft, from the Vaults! But if the Abbot's involved - then who else might be? After all, the figure he was talking to could have been anyone in the Abbey!

Corridor of Contemplation
The ancient stones of the Abbey rise to about shoulder-height before arching over, forcing me to bow my head in supplication before the Abbot's door, back east. To the west, I can hear the gentle echo of ticks and tocks coming from the Abbey's main hall.

Carved into the walls are a series of pious engravings, depicting the long path from initiate to Abbot.

>undo
Abbot's Quarters
[Previous turn undone.]

* * *

>w
I can't go that way.

>undo
Attic Room
[Previous turn undone.]

* * *

>e
No fear. I'm not going back in there.

>x engravings
If someone comes, that's what I'll do, to explain why I'm here. But no-one's coming, and that means I'd better get away, fast.

>w
I dart of the tunnel, only to be stopped dead by a depressing sight. It's Calvin and Drake, hurrying in through the Abbey's Great Entry. Their mouths are white with sugar.

"Hey, you!" Drake shouts. In a moment he's got me by the ear. "What were you doing in the Abbot's room? That's not on your rota!"

"Yeah!" Calvin adds. "And why are you slipping away when we told you to be there?"

"Idiot," Drake hisses. Louder - for the benefit of any passing monks - he says, "That's it, Wren. You're consigned to your room." For good measure, he punches me on the arm, then the two of them drag me away, heels over flagstones, right to the bottom of the ladder.

"Up you go," Calvin says. "And you're not to come down till dark!"

"What about dinner?" I ask.

"Should have thought of that, shouldn't you?" Drake says.

"More for us," Calvin adds. "Only two hours to go. I'm starved."

With that, they punch me again, and wait until I scurry away up the ladder.

Attic Room
This isn't really an attic. It isn't really a room either. It's a couple of floorboards laid across some roof rafters right in the ceiling of the Abbey. There's enough floor-space for a cot and a laundry crate, but I have to be careful not to roll out of bed, because if I do, the thick cobwebs all around aren't going to stop me from falling….

A little hole in the ceiling provides some sunlight: and when it rains, it means I can wash my hair, too. It's right above the rickety ladder down to the ground (and that means the ladder is starting to rot and bend).

Through my window I can see the Cathedral across the yard outside. If I was a bird, I could escape easily, and tell someone what I've overheard. The Abbot's about to do something terrible and I've got to stop him! Someone at the Cathedral would listen: the Archbishop himself, perhaps. He might remember me from the time he visited, when he helped me repair an altimeter I'd broken. If only I could fly.

But perhaps I can escape on foot. If I'm clever. Clockwise.

>x window
On tiptoes, I can see right across the city of St Philip. It's a maze of rooftops like a tangle of thorn bushes. If people could only see this view, then they might not be so strict about Precision and Good Order… Or maybe they would, because looming over all the houses are the great spires of the Cathedral of Time, its great clock keeping time for the whole city.

>d
I scramble quickly down the ladder.

Rickety Stair
I'm in one corner of the Great Hall, just by the foot of the ladder up to my room. There's a note attached to it, asking Amble the caretaker not to put it back in the shed just yet.

* * *

>lie on cot
I didn't understand that sentence.

>stand on cot
Stretching out on the cot gives me a good view through my window. I can see the spires of the Cathedral, tipping with Time's Arrows and flocked with birds. The Archbishop would listen, I'm thinking. If only I could reach him.

>get on cot
There's no time for that, Wren!

>x city
On tiptoes, I can see right across the city of St Philip. It's a maze of rooftops like a tangle of thorn bushes. If people could only see this view, then they might not be so strict about Precision and Good Order… Or maybe they would, because looming over all the houses are the great spires of the Cathedral of Time, its great clock keeping time for the whole city.

>touch city
It's outside the window.

>x cathedral
Twelve spires arranged in a ring about the Great Dome, to mirror the Twelve Devotions of the Greater Rotation. Rumour among initiates has it that the Cathedral was once a sundial that marked the time by casting shadows on numerals scattered about the city, but that St Newton abolished that, tore up the numerals and hid them away. They say there are twelve different numbers that used to be the first twelve but now no-one is allowed to use them. I don't believe a word of it, of course.

>touch cathedral
It's right across the city from me!

>climb spires
It's right across the city from me!

>inv
I am carrying:
  my lucky clock key (being worn)
  a rag
  a tumbler

>put tumbler on cathedral
It's right across the city from me!

>inv
I am carrying:
  my lucky clock key (being worn)
  a rag
  a tumbler

* * *

>x window
On tiptoes, I can see right across the city of St Philip. It's a maze of rooftops like a tangle of thorn bushes. If people could only see this view, then they might not be so strict about Precision and Good Order… Or maybe they would, because looming over all the houses are the great spires of the Cathedral of Time, its great clock keeping time for the whole city.

>climb up ladder
The ladder only goes down from here.

>x ladder
I see nothing special about the old construction ladder.

>climb up
I can't go that way.

>climb down
(first opening the old construction ladder)

Rickety Stair
I'm in one corner of the Great Hall, just by the foot of the ladder up to my room. There's a note attached to it, asking Amble the caretaker not to put it back in the shed just yet.

One of the old construction ladders left over from the building of the Abbey. It's a real antique. Some rungs are missing and the middle bends inwards. I can still climb it in my sleep, of course. The ladder leads up to my room.

>undo
Attic Room
[Previous turn undone.]

* * *

>x window
The narrow-barred window catches the morning sunshine. The same sunshine that Drake and Calvin are out enjoying while I'm stuck in here.

"And don't come out till that clock's shining!" shouts Drake from the hall.

"Yeah," Calvin says. "It's got to look as good as if we did it!"

"Idiot," Drake mutters. "Come on."

Their voices disappear down the hall.

>jump
I jump on the spot, fruitlessly.

The grandfather clock ticks off a minute with a stately thunk. Quickly, I make the sign of the winding gear.

>sw
I can't go that way.

From the hallway outside comes the echo of voices. Too shaky to be Calvin or Drake. More like - oh, no. It's the Abbot, coming back to his room. And if he finds me here, then my springs won't be worth the spindles they're sprung to…

>open clock
I open the clock door and peek inside. For a big clock it's got a pretty small penduluum, about the size of Calvin's fist and not as big as Drake's. There's even enough space in front of it for the Abbot to hang up one of his spare robes.

The Abbot's voice is getting closer. The old man may move slower than a short hand, but he's definitely coming this way.

>get in clock
"We'll talk in here," I hear the Abbot saying, from right outside the door. "More private. More quiet. Much better." The old man steps inside the room, followed by a tall figure in grey. In the last tick before his old eyes can see me, I dive inside the gigantic clock case and pull closed the door.

Inside Clock Case
As the phrase goes, I'm stuck between a rack and a gear-trace; except here I'm in the narrow gap between the clock case door and the heavy swinging penduluum behind. And if that hit me, and disrupted the holy timings… well, there's no way they wouldn't notice when the clock-hands stopped moving, let's just say.

A little light shines in through the keyhole, which is almost covered by the Abbot's spare robe.

Oh, no… That click outside was the sound of the Abbot closing the door. Looks like he - and the grey figure I glimpsed with him - are going to be here for a while…

>listen with tumbler
Oh… well, then. I tip out the last of the polish onto the floor of the clock. At least that part will shine.

I put the glass tumbler carefully against the door, then lean down to press my ear against it. Fantastic! I can hear much more clearly now!

"I told you now didn't I tell you?" old Abbot Gubbler is saying, plaintively. "Here? Why here? You shouldn't have come here."

The Figure says something in reply. With the glass, I can hear quite clearly. That was a good idea. "We have been disappointed with your failure. The cause and effect principle, Abbot. Such failure must bring consequences."

* * *

>z
Time passes.

"But these things, these things are not always tick-tock, they never are," the old man replies. His voice is quivering, quite different from the steady drone he has when intoning in Chapel. "The - item you asked about - it's in the Vaults, you see? The Vaults. Even if I could get in, I …"

"Your excuses we find disappointing. Very disappointing. More of this and, Abbot, we may need to unslip your gears completely."

>remove tumbler
I'm not wearing that.

The Abbot is spluttering and choking. You've seen him like this only once, when as a young initiate you dropped and smashed an altimeter right before the Archbishop was due to visit.

The Figure continues. "Clearly you're too old to steal the item for us. We have a better mechanism for obtaining it. But you must provide us with the opportunity. Is that understood?"

The Abbot nods violently, shaking out agreement the way I might beat dirt from a duster. "My money?" he asks.

>remove tumbler from door
I can't see any such thing.

>remove tumbler from clock door
I can't see any such thing.

>z
Time passes.

There's the clink, of a pouch of golden minutes. A heavy pouch. The Figure, paying the Abbot…? Then suddenly, there's a third voice. "Sorry, Father, to interrupt, but you said…"

It's a monk of the Abbey. "Get out!" the Abbot screeches. His bearing's lost its oil, it seems. "Get out, get out!"

"But Father," the monk continues, "it's time, you know. You told me to tell you when it was time."

"Oh! Of course of course," he mumbles. "I'll… We'll continue this discussion later, then," he says, to the Figure.

"We certainly will," the Figure replies.

The Abbot leaves, and that leaves me alone, inside this clock, with the stranger outside. He's coming nearer… I can hear his fingers on the door of the case! I must have nudged the penduluum, he must have seen the clock-hands quiver… but then, there's the swish of his cloak as he moves away, and the click as the door closes. Phew.

* * *

>w
Just in time, I see Drake's there. I hang back, to let him move on.

>w
I dart of the tunnel, only to be stopped dead by a depressing sight. It's Calvin and Drake, hurrying in through the Abbey's Great Entry. Their mouths are white with sugar.

"Hey, you!" Drake shouts. In a moment he's got me by the ear. "What were you doing in the Abbot's room? That's not on your rota!"

"Yeah!" Calvin adds. "And why are you slipping away when we told you to be there?"

"Idiot," Drake hisses. Louder - for the benefit of any passing monks - he says, "That's it, Wren. You're consigned to your room." For good measure, he punches me on the arm, then the two of them drag me away, heels over flagstones, right to the bottom of the ladder.

"Up you go," Calvin says. "And you're not to come down till dark!"

"What about dinner?" I ask.

"Should have thought of that, shouldn't you?" Drake says.

"More for us," Calvin adds. "Only two hours to go. I'm starved."

With that, they punch me again, and wait until I scurry away up the ladder.

Attic Room
This isn't really an attic. It isn't really a room either. It's a couple of floorboards laid across some roof rafters right in the ceiling of the Abbey. There's enough floor-space for a cot and a laundry crate, but I have to be careful not to roll out of bed, because if I do, the thick cobwebs all around aren't going to stop me from falling….

A little hole in the ceiling provides some sunlight: and when it rains, it means I can wash my hair, too. It's right above the rickety ladder down to the ground (and that means the ladder is starting to rot and bend).

I can see a pencil sketch here.

Through my window I can see the Cathedral across the yard outside. If I was a bird, I could escape easily, and tell someone what I've overheard. The Abbot's about to do something terrible and I've got to stop him! Someone at the Cathedral would listen: the Archbishop himself, perhaps. He might remember me from the time he visited, when he helped me repair an altimeter I'd broken. If only I could fly.

But perhaps I can escape on foot. If I'm clever. Clockwise.

>lie on bed
I can't see any such thing.

>lie on coy
I can't see any such thing.

>lie on cot
Stretching out on the cot gives me a good view through my window. I can see the spires of the Cathedral, tipping with Time's Arrows and flocked with birds. The Archbishop would listen, I'm thinking. If only I could reach him.

>d
I scramble quickly down the ladder.

Rickety Stair
I'm in one corner of the Great Hall, just by the foot of the ladder up to my room. There's a note attached to it, asking Amble the caretaker not to put it back in the shed just yet.

* * *

>x clock
No wonder Calvin and Drake didn't want to do this. Abbot Gubbler's Grandfather clock is enormous: the face is the size of a dinnerplate and the cabinet below is big enough to be a wardrobe. Even just polishing the doors will take half an hour. The whole thing might take all day.

"And don't come out till that clock's shining!" shouts Drake from the hall.

"Yeah," Calvin says. "It's got to look as good as if we did it!"

"Idiot," Drake mutters. "Come on."

Their voices disappear down the hall.

>clean clock
I whisper the correct mantra against the evils of Friction and Dust, and start polishing. This'll take forever!

The grandfather clock ticks off a minute with a stately thunk. Quickly, I make the sign of the winding gear.

>x cot
The Abbot's cot is a hard wooden pallet, with no pillow and one small blanket. "Mustn't sleep," I can hear him saying. "Time doesn't sleep. Sleep is our great weakness."

From the hallway outside comes the echo of voices. Too shaky to be Calvin or Drake. More like - oh, no. It's the Abbot, coming back to his room. And if he finds me here, then my springs won't be worth the spindles they're sprung to…

>x pallet
I can't see any such thing.

>enter clock
"We'll talk in here," I hear the Abbot saying, from right outside the door. "More private. More quiet. Much better." The old man steps inside the room, followed by a tall figure in grey. In the last tick before his old eyes can see me, I dive inside the gigantic clock case and pull closed the door.

Inside Clock Case
As the phrase goes, I'm stuck between a rack and a gear-trace; except here I'm in the narrow gap between the clock case door and the heavy swinging penduluum behind. And if that hit me, and disrupted the holy timings… well, there's no way they wouldn't notice when the clock-hands stopped moving, let's just say.

A little light shines in through the keyhole, which is almost covered by the Abbot's spare robe.

Oh, no… That click outside was the sound of the Abbot closing the door. Looks like he - and the grey figure I glimpsed with him - are going to be here for a while…

>hide under penduluum
To stop a clock is like murder. To shift the balance… that's something even worse still.

"I told you now didn't I tell you?" old Abbot Gubbler is saying, plaintively. "Here? Why here? You shouldn't have come here."

The Figure says something in reply. I can only hear two words, but they're enough to stop my heart. "Failure," and "Consequences."

* * *

>hide in window
There's no way inside that!

"And don't come out till that clock's shining!" shouts Drake from the hall.

"Yeah," Calvin says. "It's got to look as good as if we did it!"

"Idiot," Drake mutters. "Come on."

Their voices disappear down the hall.

>hide in abbot's door
There's no way inside that!

The grandfather clock ticks off a minute with a stately thunk. Quickly, I make the sign of the winding gear.

>hide in clock
There's no way inside that!

From the hallway outside comes the echo of voices. Too shaky to be Calvin or Drake. More like - oh, no. It's the Abbot, coming back to his room. And if he finds me here, then my springs won't be worth the spindles they're sprung to…

>hide in clock
There's no way inside that!

The Abbot's voice is getting closer. The old man may move slower than a short hand, but he's definitely coming this way.

* * *

>ask me about sparrows
There is no reply.

"And don't come out till that clock's shining!" shouts Drake from the hall.

"Yeah," Calvin says. "It's got to look as good as if we did it!"

"Idiot," Drake mutters. "Come on."

Their voices disappear down the hall.

* * *

>ask me about pie
"And don't come out till that clock's shining!" shouts Drake from the hall.

"Yeah," Calvin says. "It's got to look as good as if we did it!"

"Idiot," Drake mutters. "Come on."

Their voices disappear down the hall.

>ask me about pie
The grandfather clock ticks off a minute with a stately thunk. Quickly, I make the sign of the winding gear.

>ask me about default
There is no reply.

From the hallway outside comes the echo of voices. Too shaky to be Calvin or Drake. More like - oh, no. It's the Abbot, coming back to his room. And if he finds me here, then my springs won't be worth the spindles they're sprung to…

>enter clock
"We'll talk in here," I hear the Abbot saying, from right outside the door. "More private. More quiet. Much better." The old man steps inside the room, followed by a tall figure in grey. In the last tick before his old eyes can see me, I dive inside the gigantic clock case and pull closed the door.

Inside Clock Case
As the phrase goes, I'm stuck between a rack and a gear-trace; except here I'm in the narrow gap between the clock case door and the heavy swinging penduluum behind. And if that hit me, and disrupted the holy timings… well, there's no way they wouldn't notice when the clock-hands stopped moving, let's just say.

A little light shines in through the keyhole, which is almost covered by the Abbot's spare robe.

Oh, no… That click outside was the sound of the Abbot closing the door. Looks like he - and the grey figure I glimpsed with him - are going to be here for a while…

>ask abbot about foo
Draw attention to myself? I may be honest, but I'm not stupid. If I get kicked out of the Abbey I'll be nothing but a street urchin for the rest of a very short life.

"I told you now didn't I tell you?" old Abbot Gubbler is saying, plaintively. "Here? Why here? You shouldn't have come here."

The Figure says something in reply. I can only hear two words, but they're enough to stop my heart. "Failure," and "Consequences."

>ask abbot about default
Draw attention to myself? I may be honest, but I'm not stupid. If I get kicked out of the Abbey I'll be nothing but a street urchin for the rest of a very short life.

"But these things, these things are not always tick-tock, they never are," the old man replies. His voice is quivering, quite different from the steady drone he has when intoning in Chapel. "The - item you asked about - it's in the Vaults, you see? The Vaults. Even if I could get in, I …"

The Figure is too far from the keyhole and speaks too quietly for me to hear clearly. "Disappointing," he says; and then "unslip your gears."

>z
Time passes.

The Abbot is spluttering and choking. You've seen him like this only once, when as a young initiate you dropped and smashed an altimeter right before the Archbishop was due to visit.

The Figure's quiet voice continues. I can make out; "too old to steal", "a better mechanism", "the opportunity."

The Abbot nods violently, shaking out agreement the way I might beat dirt from a duster. "My money?" he asks.

>ask figure about foo
Draw attention to myself? I may be honest, but I'm not stupid. If I get kicked out of the Abbey I'll be nothing but a street urchin for the rest of a very short life.

There's the clink, of a pouch of golden minutes. A heavy pouch. The Figure, paying the Abbot…? Then suddenly, there's a third voice. "Sorry, Father, to interrupt, but you said…"

It's a monk of the Abbey. "Get out!" the Abbot screeches. His bearing's lost its oil, it seems. "Get out, get out!"

"But Father," the monk continues, "it's time, you know. You told me to tell you when it was time."

"Oh! Of course of course," he mumbles. "I'll… We'll continue this discussion later, then," he says, to the Figure.

The Figure intones something in reply.

The Abbot leaves, and that leaves me alone, inside this clock, with the stranger outside. He's coming nearer… I can hear his fingers on the door of the case! I must have nudged the penduluum, he must have seen the clock-hands quiver… but then, there's the swish of his cloak as he moves away, and the click as the door closes. Phew.

>z
Time passes.

* * *

>ne
Library
The Abbey's library is small compared to the one in the Cathedral. There's nothing on the shelves but the key texts: the Principia, the Mechanistica and the Determininium. Only Brother Horloge, the Abbey's Primary Reader ever seems to use them - he's here at the moment, studying at his desk by the poor light coming through the stained glass windows. By his elbow is a fat bunch of keys. On his shoulder is his mechanical owl, wings folded.

An archway leads east back into the hall. From the southwest comes the clatter of Writing hammers and the sharp smell of burnt ink.

>ask horloge about foo
I open my mouth to speak.

"Look here, Whotsit," he interrupts. "I've been at these books all day. Grappling with the Mysteries of the Whotsit. A cup of whotsit, that's all I want."

>ask horloge about default
I open my mouth to speak.

"Don't stand there babbling," Horloge interrupts. "I mean, really, very simple. Just a cup of… a cup of… you know. Yes."

Horloge's finger shakes terribly as he traces the Holy Lines across the sheet.

>ask horloge about tea
"A cup of tea?" I ask.

"Of course a cup of whotsit!" Horloge replies hotly. "Do I have to say everything twice? Do I have to…" He pauses, appearing to have forgotten what he was saying. "Say everything twice?" he finishes, uncertainly. "Good."

Horloge chucks his pet own under its beak. There is no reaction.

>horloge, whotsit?
"A whotsit?" I ask.

"Yes, quite right," he replies, shaking a finger. "Nice and hot."

Brother Horloge mumbles as he traces over the sheet of manuscript.

Distantly - but not distantly enough - I can hear the clock and clatter of Drake's boots. The sound's coming from the southwest.

>horloge, whotsit
I open my mouth to speak.

"What kind of scullery maid are you?" he interrupts. Blinder than I thought, clearly. Any monk should know a 2nd Assistant Polisher when they see one.

Looking southwest, I can see Drake. He's coming this way!

>e
Central Hall
I'm standing in the very centre of the Abbey's Great Hall. It's impossible not to crane my neck here, to gaze up at the ceiling held aloft by buttresses like gigantic oak trees. To think, people built this in the days before proper pulley-transmissions! It must have taken weeks! The hall continues northeast into shadow, and southwest, towards the sunlight, the Yard and above all, the Archbishop.

The vast empty space is filled by the muttering and echo of Holy Mechanisms, and the hiss of the candles as they sweep around their Tracks, providing a little light everywhere but rarely ever enough. I can just make out archways both east and west.

I've got a moment before Drake spots me: he's just appeared, to the west.

>sw
Lower Hall
Looking northeast, the Great Hall of the Abbey stretches away like the belly of some big beast, its bony roof held up by pillars like swallowed trees. The walls are carelessly lit by candles moving through Sacred Tracks suspended in the air. I can just make out the Corridor of Contemplation to the east, and the wider archway to the Scriptorium to the west.

But more importantly, the great Entry - and exit - of the Abbey is to the southwest. And if I'm going to get out of here and talk to the Archbishop that's the only way to go.

But maybe you're starting to see what kind of luck I have. Right there, in the Entry, is Calvin, working on a clock.

* * *

>me
That's not a verb I recognize.

>ne
Library
The Abbey's library is small compared to the one in the Cathedral. There's nothing on the shelves but the key texts: the Principia, the Mechanistica and the Determininium. Only Brother Horloge, the Abbey's Primary Reader ever seems to use them - he's here at the moment, studying at his desk by the poor light coming through the stained glass windows. By his elbow is a fat bunch of keys. On his shoulder is his mechanical owl, wings folded.

An archway leads east back into the hall. From the southwest comes the clatter of Writing hammers and the sharp smell of burnt ink.

Horloge chucks his pet own under its beak. There is no reaction.

>ask horloge about tea
"A cup of tea?" I ask.

"Of course a cup of whotsit!" Horloge replies hotly. "Do I have to say everything twice? Do I have to…" He pauses, appearing to have forgotten what he was saying. "Say everything twice?" he finishes, uncertainly. "Good."

* * *

>horloge, whotsit
I open my mouth to speak.

"What kind of scullery maid are you?" he interrupts. Blinder than I thought, clearly. Any monk should know a 2nd Assistant Polisher when they see one.

Looking southwest, I can see Drake. He's coming this way!

>horloge, foo
Brother Horloge mumbles as he traces over the sheet of manuscript.

"Wren!" Drake exclaims. He wallops me on the arm. "I thought I told you to stay in your room?" He doesn't wait for an excuse before I'm dragged off to the ladder. Then he waits - and wallops me - until I give in and climb all the way back up.

Attic Room
This isn't really an attic. It isn't really a room either. It's a couple of floorboards laid across some roof rafters right in the ceiling of the Abbey. There's enough floor-space for a cot and a laundry crate, but I have to be careful not to roll out of bed, because if I do, the thick cobwebs all around aren't going to stop me from falling….

A little hole in the ceiling provides some sunlight: and when it rains, it means I can wash my hair, too. It's right above the rickety ladder down to the ground (and that means the ladder is starting to rot and bend).

That was careless, getting caught. But I can still make it to the Cathedral. I'll just have to be more cunning this time. Remember, Wren, it's easy: the whole world runs on clockwork. Just a matter of staying ahead of the biting teeth.

* * *

>ne
Library
The Abbey's library is small compared to the one in the Cathedral. There's nothing on the shelves but the key texts: the Principia, the Mechanistica and the Determininium. Only Brother Horloge, the Abbey's Primary Reader ever seems to use them - he's here at the moment, studying at his desk by the poor light coming through the stained glass windows. By his elbow is a fat bunch of keys. On his shoulder is his mechanical owl, wings folded.

An archway leads east back into the hall. From the southwest comes the clatter of Writing hammers and the sharp smell of burnt ink.

>ask monk about keys
I open my mouth to speak.

"Look here, Whotsit," he interrupts. "I've been at these books all day. Grappling with the Mysteries of the Whotsit. A cup of whotsit, that's all I want."

He's so enthusiastic as he talks that he knocks his keys onto the floor, though he doesn't seem to notice.

>undo
Library
[Previous turn undone.]

>rules
Rules tracing now switched on. Type "rules off" to switch it off again, or "rules all" to include even rules which do not apply.

>ask monk about keys
[Rule "Before asking Horloge about something for the first time" applies.]
I open my mouth to speak.

"Look here, Whotsit," he interrupts. "I've been at these books all day. Grappling with the Mysteries of the Whotsit. A cup of whotsit, that's all I want."

    [Rule "After asking Horloge about something" applies.]
He's so enthusiastic as he talks that he knocks his keys onto the floor, though he doesn't seem to notice.

[Rule "Every turn during Drake's Patrol" applies.]
[Rule "standard set going variables rule" applies.]
    [Rule "can't travel in what's not a vehicle rule" applies.]
    [Rule "can't go through undescribed doors rule" applies.]
    [Rule "can't go through closed doors rule" applies.]
    [Rule "determine map connection rule" applies.]
    [Rule "can't go that way rule" applies.]
    [Rule "move player and vehicle rule" applies.]
    [Rule "move floating objects rule" applies.]
    [Rule "check light in new location rule" applies.]
    [Rule "After Drake going" applies.]

* * *

>ask monk about keys
I open my mouth to speak.

"Look here, Whotsit," he interrupts. "I've been at these books all day. Grappling with the Mysteries of the Whotsit. A cup of whotsit, that's all I want."

He's so enthusiastic as he talks that he knocks his keys onto the floor, though he doesn't seem to notice.

>get keys
I wait for old Horloge to lose himself in his manuscript and then snaffle the keys from the ground. But he notices me, of course. "Thank-you, young Whotsit," he says. "Just put them down on the table, there's a whotsit." I do as I'm told.

>x keys
A thick bunch of keys, to most of the Abbey's locks and clocks alike.

>inv
I am carrying:
  my lucky clock key (being worn)
  a rag
  a tumbler
    a small amount of polish

Distantly - but not distantly enough - I can hear the clock and clatter of Drake's boots. The sound's coming from the southwest.

>e
Central Hall
I'm standing in the very centre of the Abbey's Great Hall. It's impossible not to crane my neck here, to gaze up at the ceiling held aloft by buttresses like gigantic oak trees. To think, people built this in the days before proper pulley-transmissions! It must have taken weeks! The hall continues northeast into shadow, and southwest, towards the sunlight, the Yard and above all, the Archbishop.

The vast empty space is filled by the muttering and echo of Holy Mechanisms, and the hiss of the candles as they sweep around their Tracks, providing a little light everywhere but rarely ever enough. I can just make out archways both east and west.

Drake's clattering boots are audible to the west.

* * *

>ne
Library
The Abbey's library is small compared to the one in the Cathedral. There's nothing on the shelves but the key texts: the Principia, the Mechanistica and the Determininium. Only Brother Horloge, the Abbey's Primary Reader ever seems to use them - he's here at the moment, studying at his desk by the poor light coming through the stained glass windows. By his elbow is a fat bunch of keys. On his shoulder is his mechanical owl, wings folded.

An archway leads east back into the hall. From the southwest comes the clatter of Writing hammers and the sharp smell of burnt ink.

Horloge reaches up to pet his owl. The bird is motionless.

>get keys
Brother Horloge puts out a worn-out old hand. "Now don't you wander off with my keys," he says. "They're very important."

Horloge's finger shakes terribly as he traces the Holy Lines across the sheet.

>ask brother horloge about keys
I open my mouth to speak.

"Don't stand there babbling," Horloge interrupts. "I mean, really, very simple. Just a cup of… a cup of… you know. Yes."

He knocks his keys back onto the floor.

>ask brother horloge about keys
I open my mouth to speak.

"What kind of scullery maid are you?" he interrupts. Blinder than I thought, clearly. Any monk should know a 2nd Assistant Polisher when they see one.

>rules
Rules tracing now switched on. Type "rules off" to switch it off again, or "rules all" to include even rules which do not apply.

>ask brother horloge about keys
[Rule "Report asking someone about something" applies.]
I open my mouth to speak.

"A cup of whotsit, whotsit," he insists. "And don't spare the horses."

    [Rule "After speaking with Horloge" applies.]
[Rule "Every turn during Drake's Patrol" applies.]
[Rule "standard set going variables rule" applies.]
    [Rule "can't travel in what's not a vehicle rule" applies.]
    [Rule "can't go through undescribed doors rule" applies.]
    [Rule "can't go through closed doors rule" applies.]
    [Rule "determine map connection rule" applies.]
    [Rule "can't go that way rule" applies.]
    [Rule "move player and vehicle rule" applies.]
    [Rule "move floating objects rule" applies.]
    [Rule "check light in new location rule" applies.]
    [Rule "After Drake going" applies.]

>ask brother horloge about tea
[Rule "Report asking someone about something" applies.]
"A cup of tea?" I ask.

"Of course a cup of whotsit!" Horloge replies hotly. "Do I have to say everything twice? Do I have to…" He pauses, appearing to have forgotten what he was saying. "Say everything twice?" he finishes, uncertainly. "Good."

    [Rule "After speaking with Horloge" applies.]
[Rule "Every turn during Drake's Patrol" applies.]
[Rule "standard set going variables rule" applies.]
    [Rule "can't travel in what's not a vehicle rule" applies.]
    [Rule "can't go through undescribed doors rule" applies.]
    [Rule "can't go through closed doors rule" applies.]
    [Rule "determine map connection rule" applies.]
    [Rule "can't go that way rule" applies.]
    [Rule "move player and vehicle rule" applies.]
    [Rule "move floating objects rule" applies.]
    [Rule "check light in new location rule" applies.]
    [Rule "After Drake going" applies.]
Drake's on patrol, and I can hear him heading this way, from the southwest.

* * *

>get keys
I wait for old Horloge to lose himself in his manuscript and then snaffle the keys from the ground. But he notices me, of course. "Thank-you, young Whotsit," he says. "Just put them down on the table, there's a whotsit." I do as I'm told.

>ask monk about whotsit
"A whotsit?" I ask.

"Yes, quite right," he replies, shaking a finger. "Nice and hot."

He knocks his keys back onto the floor.

>get keys
Just as before: he sees me pick the keys up, and takes them back.

Distantly - but not distantly enough - I can hear the clock and clatter of Drake's boots. The sound's coming from the southwest.

>ask monk about tea
"A cup of tea?" I ask.

"Of course a cup of whotsit!" Horloge replies hotly. "Do I have to say everything twice? Do I have to…" He pauses, appearing to have forgotten what he was saying. "Say everything twice?" he finishes, uncertainly. "Good."

He knocks his keys onto the floor again.

Drake's just off to the southwest, and he's coming this way!

>e
Central Hall
I'm standing in the very centre of the Abbey's Great Hall. It's impossible not to crane my neck here, to gaze up at the ceiling held aloft by buttresses like gigantic oak trees. To think, people built this in the days before proper pulley-transmissions! It must have taken weeks! The hall continues northeast into shadow, and southwest, towards the sunlight, the Yard and above all, the Archbishop.

The vast empty space is filled by the muttering and echo of Holy Mechanisms, and the hiss of the candles as they sweep around their Tracks, providing a little light everywhere but rarely ever enough. I can just make out archways both east and west.

Looking west, I can see Drake. He's coming this way!

>sw
Lower Hall
Looking northeast, the Great Hall of the Abbey stretches away like the belly of some big beast, its bony roof held up by pillars like swallowed trees. The walls are carelessly lit by candles moving through Sacred Tracks suspended in the air. I can just make out the Corridor of Contemplation to the east, and the wider archway to the Scriptorium to the west.

But more importantly, the great Entry - and exit - of the Abbey is to the southwest. And if I'm going to get out of here and talk to the Archbishop that's the only way to go.

But maybe you're starting to see what kind of luck I have. Right there, in the Entry, is Calvin, working on a clock.

* * *

>ne
Library
The Abbey's library is small compared to the one in the Cathedral. There's nothing on the shelves but the key texts: the Principia, the Mechanistica and the Determininium. Only Brother Horloge, the Abbey's Primary Reader ever seems to use them - he's here at the moment, studying at his desk by the poor light coming through the stained glass windows. On the floor by his feet is a fat bunch of keys. On his shoulder is his mechanical owl, wings folded.

An archway leads east back into the hall. From the southwest comes the clatter of Writing hammers and the sharp smell of burnt ink.

* * *

>get keys
I wait for old Horloge to lose himself in his manuscript and then snaffle the keys from the ground. But he notices me, of course. "Thank-you, young Whotsit," he says. "Just put them down on the table, there's a whotsit." I do as I'm told.

>ask monk about keys
I open my mouth to speak.

"Don't stand there babbling," Horloge interrupts. "I mean, really, very simple. Just a cup of… a cup of… you know. Yes."

He knocks his keys back onto the floor.

>move keys
Those are fixed in place.

Distantly - but not distantly enough - I can hear the clock and clatter of Drake's boots. The sound's coming from the southwest.

* * *

>e
Kitchen
If there was ever a proof of the perfection of Clockwork over Nature, it's that the dirtiest and most hectic room in the whole Abbey is its Kitchen. Shelves, walls and floor are covered by machines belching, slicing, steaming, chopping, stirring, boiling, broiling, frying, pureeing … the list goes on. The noise, smell and heat is almost overpowering, and the Cook, who controls this madhouse, can only stand it because he's stone deaf.

>w
Upper Hall
The Great Hall of the Abbey is the biggest room I've seen in my life, running from this end all the way southwest (and it is all the way, I'm never allowed further) to the Great Doors and the Yard outside. If I crane my neck I can see the dark square of the floorboards of my room - the ladder is on one side, to the west. Lights move in and out overhead, from the candles moving on their Holy Tracks. Strong smells float through an archway to the east.

From their niches, the Three Major Saints are watching sternly, keen that I should get out of the Cathedral and talk to the Archbishop as quickly as possible.

* * *

>e
West Refectory
I spend some of my time here, eating at one of the two long tables. I spend even more serving the monks. Each of them has their own seat, marked by a little brass hourglass, and if the twenty or so I can see here weren't enough (which they aren't), there's more to the east, where the Refectory continues. Back west is the archway to the Great Hall.

On the table is a single empty teacup, left over from breakfast.

>showme
West Refectory - room
    myself - person
        my lucky clock key (worn)
        rag
        tumbler - open container
            small amount of polish

>show me long tables
I can't see any such thing.

>showme long tables
long tables - supporter
    teacup
location: in the Rickety Stair
enterable; unlit; inedible; transparent; fixed in place; plural-named; improper-named
description: Two long oak tables flanked by benches. Each monk's place is marked by an hourglass, fixed to a brass rod along the centre of the table.
printed name: long tables
printed plural name: supporters
reading matter:

* * *

>e
West Refectory
I spend some of my time here, eating at one of the two long tables. I spend even more serving the monks. Each of them has their own seat, marked by a little brass hourglass, and if the twenty or so I can see here weren't enough (which they aren't), there's more to the east, where the Refectory continues. Back west is the archway to the Great Hall.

On the table is a single empty teacup, left over from breakfast.

>x cup
A porcelain teacup. The edges are a little chipped from overuse. It's next to Brother Horloge's hourglass.

>get cup
Taken.

>l
West Refectory
I spend some of my time here, eating at one of the two long tables. I spend even more serving the monks. Each of them has their own seat, marked by a little brass hourglass, and if the twenty or so I can see here weren't enough (which they aren't), there's more to the east, where the Refectory continues. Back west is the archway to the Great Hall.

* * *

>x cup
A porcelain teacup. The edges are a little chipped from overuse. It's next to Brother Horloge's hourglass.

>x hourglasses
Little polished hourglasses, each with a name inscribed at the base. They run on a metal bar so they can be easily flipped. "There is time for eating," so they say, "but only the right amount of time." Next to Horloge's hourglass is an empty tea cup.

>get cup
Taken.

>x hourglasses
Little polished hourglasses, each with a name inscribed at the base. They run on a metal bar so they can be easily flipped. "There is time for eating," so they say, "but only the right amount of time."

* * *

>w
Library
The Abbey's library is small compared to the one in the Cathedral. There's nothing on the shelves but the key texts: the Principia, the Mechanistica and the Determininium. Only Brother Horloge, the Abbey's Primary Reader ever seems to use them - he's here at the moment, studying at his desk by the poor light coming through the stained glass windows. By his elbow is a fat bunch of keys. On his shoulder is his mechanical owl, wings folded.

An archway leads east back into the hall. From the southwest comes the clatter of Writing hammers and the sharp smell of burnt ink.

Horloge looks up as I enter. "Ah, young - young Whotsit!" he bellows, pointing a fat finger in my general direction, though through his thick multi-lensed spectacles I don't think he can quite see where I am. "Look here!" he demands. "Young Whotsit-whoever-you-are! I need some - some of that, you know. Some of that whotsit. A good… of whotsit? Uh-huh? Good? Good." He smiles, then looks back down to his studies, muttering.

Horloge reaches up to pet his owl. The bird is motionless.

>l
Library
The Abbey's library is small compared to the one in the Cathedral. There's nothing on the shelves but the key texts: the Principia, the Mechanistica and the Determininium. Only Brother Horloge, the Abbey's Primary Reader ever seems to use them - he's here at the moment, studying at his desk by the poor light coming through the stained glass windows. By his elbow is a fat bunch of keys. On his shoulder is his mechanical owl, wings folded.

An archway leads east back into the hall. From the southwest comes the clatter of Writing hammers and the sharp smell of burnt ink.

Horloge looks up as I enter. "Ah, young - young Whotsit!" he bellows, pointing a fat finger in my general direction, though through his thick multi-lensed spectacles I don't think he can quite see where I am. "Look here!" he demands. "Young Whotsit-whoever-you-are! I need some - some of that, you know. Some of that whotsit. A good… of whotsit? Uh-huh? Good? Good." He smiles, then looks back down to his studies, muttering.

Brother Horloge mumbles as he traces over the sheet of manuscript.

* * *

>ask horloge about whotsit
I open my mouth to speak.

"Look here, Whotsit," he interrupts. "I've been at these books all day. Grappling with the Mysteries of the Whotsit. A cup of whotsit, that's all I want."

He's so enthusiastic as he talks that he knocks his keys onto the floor, though he doesn't seem to notice.

Horloge chucks his pet own under its beak. There is no reaction.

>ask horloge about kets
I open my mouth to speak.

"Don't stand there babbling," Horloge interrupts. "I mean, really, very simple. Just a cup of… a cup of… you know. Yes."

>ask horloge about keys
I open my mouth to speak.

"What kind of scullery maid are you?" he interrupts. Blinder than I thought, clearly. Any monk should know a 2nd Assistant Polisher when they see one.

Distantly - but not distantly enough - I can hear the clock and clatter of Drake's boots. The sound's coming from the southwest.

>x owl
I can't see any such thing.

* * *

>enter cot
No thanks. It looks horribly uncomfortable. And coming from me, considering where I sleep, that's really saying something.

"And don't come out till that clock's shining!" shouts Drake from the hall.

"Yeah," Calvin says. "It's got to look as good as if we did it!"

"Idiot," Drake mutters. "Come on."

Their voices disappear down the hall.

>polish clock
I whisper the correct mantra against the evils of Friction and Dust, and start polishing. This'll take forever!

The grandfather clock ticks off a minute with a stately thunk. Quickly, I make the sign of the winding gear.

* * *

>x clock
No wonder Calvin and Drake didn't want to do this. Abbot Gubbler's Grandfather clock is enormous: the face is the size of a dinnerplate and the cabinet below is big enough to be a wardrobe. Even just polishing the doors will take half an hour. The whole thing might take all day.

From the hallway outside comes the echo of voices. Too shaky to be Calvin or Drake. More like - oh, no. It's the Abbot, coming back to his room. And if he finds me here, then my springs won't be worth the spindles they're sprung to…

>hide in clock
"We'll talk in here," I hear the Abbot saying, from right outside the door. "More private. More quiet. Much better." The old man steps inside the room, followed by a tall figure in grey. In the last tick before his old eyes can see me, I dive inside the gigantic clock case and pull closed the door.

Inside Clock Case
As the phrase goes, I'm stuck between a rack and a gear-trace; except here I'm in the narrow gap between the clock case door and the heavy swinging penduluum behind. And if that hit me, and disrupted the holy timings… well, there's no way they wouldn't notice when the clock-hands stopped moving, let's just say.

A little light shines in through the keyhole, which is almost covered by the Abbot's spare robe.

Oh, no… That click outside was the sound of the Abbot closing the door. Looks like he - and the grey figure I glimpsed with him - are going to be here for a while…

* * *

>jump
I jump on the spot, fruitlessly.

"But these things, these things are not always tick-tock, they never are," the old man replies. His voice is quivering, quite different from the steady drone he has when intoning in Chapel. "The - item you asked about - it's in the Vaults, you see? The Vaults. Even if I could get in, I …"

"Your excuses we find disappointing. Very disappointing. More of this and, Abbot, we may need to unslip your gears completely."

>x penduluum
The penduluum is a large amount of Holy Brass, properly blessed and bevelled. It swings back and forth, raising the weight of Precision against the counterweight of Slapdashery.

The Abbot is spluttering and choking. You've seen him like this only once, when as a young initiate you dropped and smashed an altimeter right before the Archbishop was due to visit.

The Figure continues. "Clearly you're too old to steal the item for us. We have a better mechanism for obtaining it. But you must provide us with the opportunity. Is that understood?"

The Abbot nods violently, shaking out agreement the way I might beat dirt from a duster. "My money?" he asks.

>x weight
The penduluum is a large amount of Holy Brass, properly blessed and bevelled. It swings back and forth, raising the weight of Precision against the counterweight of Slapdashery.

There's the clink, of a pouch of golden minutes. A heavy pouch. The Figure, paying the Abbot…? Then suddenly, there's a third voice. "Sorry, Father, to interrupt, but you said…"

It's a monk of the Abbey. "Get out!" the Abbot screeches. His bearing's lost its oil, it seems. "Get out, get out!"

"But Father," the monk continues, "it's time, you know. You told me to tell you when it was time."

"Oh! Of course of course," he mumbles. "I'll… We'll continue this discussion later, then," he says, to the Figure.

"We certainly will," the Figure replies.

The Abbot leaves, and that leaves me alone, inside this clock, with the stranger outside. He's coming nearer… I can hear his fingers on the door of the case! I must have nudged the penduluum, he must have seen the clock-hands quiver… but then, there's the swish of his cloak as he moves away, and the click as the door closes. Phew.

>out
I spill gratefully out of the clock, gasping for breath as though I've been underwater. I've just been holding it in, of course. As what I've heard - well, I probably shouldn't have, and the quicker I can get out of here, the better.

Abbot's Quarters
If I thought Abbots lived in luxury, then I was dead wrong. Even my attic's cosier than this. The Abbot's got no furniture at all, except a desk and a cot, and no decoration except for a bust of St. Newton. None of the axle-mounted bevelled mobiles I was expecting. There's barely even any sunlight: one thin window to catch the sun-rise, opposite the door to the hallway back west.

St. Newton is staring at the Abbot's unpolished Grandfather clock with a severe frown.

* * *

>e
Kitchen
If there was ever a proof of the perfection of Clockwork over Nature, it's that the dirtiest and most hectic room in the whole Abbey is its Kitchen. Shelves, walls and floor are covered by machines belching, slicing, steaming, chopping, stirring, boiling, broiling, frying, pureeing … the list goes on. The noise, smell and heat is almost overpowering, and the Cook, who controls this madhouse, can only stand it because he's stone deaf.

I can escape back into the cool of the Hall to the west. South, through a broad arch, is the Refectory.

>pull lever
The Cook gawps, then troops over and belts me around the head. He points firmly at the kettle in the middle of the machine - the empty kettle in the middle of the machine - then stalks back over to his chopping machine.

>turn spigot
The spigot releases a thin dribble of water into the kettle. Across the room, the clouds coming from the steamer suddenly thin out and the Cook pauses to give me the most evil of evil stars. I turn the spigot closed again.

The cook knocks past me, to tighten the steamer.

Distantly - but not distantly enough - I can hear the clock and clatter of Drake's boots. The sound's coming from the south.

>x kettle
The brass kettle is suspended from an arm-brace under the spigot and near the burner. It's full of water.

Looking south, I can see Drake. He's coming this way!

>w
Upper Hall
The Great Hall of the Abbey is the biggest room I've seen in my life, running from this end all the way southwest (and it is all the way, I'm never allowed further) to the Great Doors and the Yard outside. If I crane my neck I can see the dark square of the floorboards of my room - the ladder is on one side, to the west. Lights move in and out overhead, from the candles moving on their Holy Tracks. Strong smells float through an archway to the east.

From their niches, the Three Major Saints are watching sternly, keen that I should get out of the Cathedral and talk to the Archbishop as quickly as possible.

Drake's just off to the east, and he's coming this way!

* * *

>e
Kitchen
If there was ever a proof of the perfection of Clockwork over Nature, it's that the dirtiest and most hectic room in the whole Abbey is its Kitchen. Shelves, walls and floor are covered by machines belching, slicing, steaming, chopping, stirring, boiling, broiling, frying, pureeing … the list goes on. The noise, smell and heat is almost overpowering, and the Cook, who controls this madhouse, can only stand it because he's stone deaf.

I can escape back into the cool of the Hall to the west. South, through a broad arch, is the Refectory.

The cook pushes past me, to respring the crumb-sucker.

>pull lever
Don't you think the tea would be rather bland if I don't put some tea in? The machine is clockwork but it's not magic, you know!

The cook knocks past me, to wind the broiler.

>get leaves
(the tea leaves)
I scoop up a handful of tea leaves.

The cook bustles past me, to thump the oven.

>put leaves in basket
(the handful of tea leaves in the basket)
The basket's now filled with tea leaves.

The cook knocks past me, to wind the grater.

Drake's clattering boots are audible to the south.

>pull lever
Everything's set, certainly, except there's nowhere for the tea to go - except out of the basket, through the semi-circular bracket where the tea-cup's supposed to go, and them all over my feet.

I've got a moment before Drake spots me: he's just appeared, to the south.

>w
Upper Hall
The Great Hall of the Abbey is the biggest room I've seen in my life, running from this end all the way southwest (and it is all the way, I'm never allowed further) to the Great Doors and the Yard outside. If I crane my neck I can see the dark square of the floorboards of my room - the ladder is on one side, to the west. Lights move in and out overhead, from the candles moving on their Holy Tracks. Strong smells float through an archway to the east.

From their niches, the Three Major Saints are watching sternly, keen that I should get out of the Cathedral and talk to the Archbishop as quickly as possible.

Looking east, I can see Drake. He's coming this way!

* * *

>s
I can't go that way.

>sw
Central Hall
I'm standing in the very centre of the Abbey's Great Hall. It's impossible not to crane my neck here, to gaze up at the ceiling held aloft by buttresses like gigantic oak trees. To think, people built this in the days before proper pulley-transmissions! It must have taken weeks! The hall continues northeast into shadow, and southwest, towards the sunlight, the Yard and above all, the Archbishop.

The vast empty space is filled by the muttering and echo of Holy Mechanisms, and the hiss of the candles as they sweep around their Tracks, providing a little light everywhere but rarely ever enough. I can just make out archways both east and west.

Drake's just off to the west, and he's coming this way!

>e
West Refectory
I spend some of my time here, eating at one of the two long tables. I spend even more serving the monks. Each of them has their own seat, marked by a little brass hourglass, and if the twenty or so I can see here weren't enough (which they aren't), there's more to the east, where the Refectory continues. Back west is the archway to the Great Hall.

On the table is a single empty teacup, left over from breakfast.

I've got a moment before Drake spots me: he's just appeared, to the west.

>r
That's not a verb I recognize.

>e
East Refectory
The eastern end of the long Refectory is given over in part to the tables lined with brass hourglasses, but in the other half there's nothing but the enormous Refectory Clock. It's an impressive thing, so big because it only needs winding once a year, despite all the gongs, cymbals, tubes and bells that strike when dinner time comes around. Right now, the clock is showing the time at just after 3pm.

Pungent smells drift in from the kitchen to the north. On the east wall is the small green door to the Abbey's herb garden.

Looking west, I can see Drake. He's coming this way!

>n
Kitchen
If there was ever a proof of the perfection of Clockwork over Nature, it's that the dirtiest and most hectic room in the whole Abbey is its Kitchen. Shelves, walls and floor are covered by machines belching, slicing, steaming, chopping, stirring, boiling, broiling, frying, pureeing … the list goes on. The noise, smell and heat is almost overpowering, and the Cook, who controls this madhouse, can only stand it because he's stone deaf.

I can escape back into the cool of the Hall to the west. South, through a broad arch, is the Refectory.

Drake's just off to the south, and he's coming this way!

* * *

>e
West Refectory
I spend some of my time here, eating at one of the two long tables. I spend even more serving the monks. Each of them has their own seat, marked by a little brass hourglass, and if the twenty or so I can see here weren't enough (which they aren't), there's more to the east, where the Refectory continues. Back west is the archway to the Great Hall.

On the table is a single empty teacup, left over from breakfast.

* * *

>get cup
I pick up the empty cup from its place beside by Brother Horloge's hourglass.

>e
East Refectory
The eastern end of the long Refectory is given over in part to the tables lined with brass hourglasses, but in the other half there's nothing but the enormous Refectory Clock. It's an impressive thing, so big because it only needs winding once a year, despite all the gongs, cymbals, tubes and bells that strike when dinner time comes around. Right now, the clock is showing the time at just after 3pm.

Pungent smells drift in from the kitchen to the north. On the east wall is the small green door to the Abbey's herb garden.

>n
Kitchen
If there was ever a proof of the perfection of Clockwork over Nature, it's that the dirtiest and most hectic room in the whole Abbey is its Kitchen. Shelves, walls and floor are covered by machines belching, slicing, steaming, chopping, stirring, boiling, broiling, frying, pureeing … the list goes on. The noise, smell and heat is almost overpowering, and the Cook, who controls this madhouse, can only stand it because he's stone deaf.

I can escape back into the cool of the Hall to the west. South, through a broad arch, is the Refectory.

The cook bustles past me, to respring the masher.

>w
Upper Hall
The Great Hall of the Abbey is the biggest room I've seen in my life, running from this end all the way southwest (and it is all the way, I'm never allowed further) to the Great Doors and the Yard outside. If I crane my neck I can see the dark square of the floorboards of my room - the ladder is on one side, to the west. Lights move in and out overhead, from the candles moving on their Holy Tracks. Strong smells float through an archway to the east.

From their niches, the Three Major Saints are watching sternly, keen that I should get out of the Cathedral and talk to the Archbishop as quickly as possible.

>undo
Kitchen
[Previous turn undone.]

>put cup in bracket
Done.

>pull lever
The lever moves without resistance. It's been long enough since breakfast, clearly, that the spring has wound down.

Drake's footsteps echo in from the south.

>undo
Kitchen
[Previous turn undone.]

>turn key
(my lucky clock key)
Nothing obvious happens.

The cook scurries past me, to tighten the grater.

Drake's on patrol, and I can hear him heading this way, from the south.

>undo
Kitchen
[Previous turn undone.]

>turn tea machine key
A few turns and the spring is fully wound.

The cook pushes past me, to unclip the broiler.

Drake's footsteps echo in from the south.

>pull lever
The lever locks down and sets the first few gears in motion. But it doesn't seem to be carrying over correctly. I can't help but notice a worn down gear in the middle of the train, no longer catching teeth with its fellows. I make the sign of Sad Depreciation. I release the lever and it springs back up.

Looking south, I can see Drake. He's coming this way!

>w
Upper Hall
The Great Hall of the Abbey is the biggest room I've seen in my life, running from this end all the way southwest (and it is all the way, I'm never allowed further) to the Great Doors and the Yard outside. If I crane my neck I can see the dark square of the floorboards of my room - the ladder is on one side, to the west. Lights move in and out overhead, from the candles moving on their Holy Tracks. Strong smells float through an archway to the east.

From their niches, the Three Major Saints are watching sternly, keen that I should get out of the Cathedral and talk to the Archbishop as quickly as possible.

Drake's just off to the east, and he's coming this way!

* * *

>e
Kitchen
If there was ever a proof of the perfection of Clockwork over Nature, it's that the dirtiest and most hectic room in the whole Abbey is its Kitchen. Shelves, walls and floor are covered by machines belching, slicing, steaming, chopping, stirring, boiling, broiling, frying, pureeing … the list goes on. The noise, smell and heat is almost overpowering, and the Cook, who controls this madhouse, can only stand it because he's stone deaf.

I can escape back into the cool of the Hall to the west. South, through a broad arch, is the Refectory.

The cook bustles past me, to wind the grater.

>get gear
Which do I mean, the gear train or the small gear?

* * *

>small
While the Cook is distracted - the Cook is always distracted - I pluck the out the worn down gear. Not the sort of repair a clock polisher should be doing!

>pull lever
The lever locks down but there's a gear missing on the front of the machine, so the train of cogs can't connect. I release the lever again and it springs back up.

* * *

>ne
Library
The Abbey's library is small compared to the one in the Cathedral. There's nothing on the shelves but the key texts: the Principia, the Mechanistica and the Determininium. Only Brother Horloge, the Abbey's Primary Reader ever seems to use them - he's here at the moment, studying at his desk by the poor light coming through the stained glass windows. By his elbow is a fat bunch of keys. On his shoulder is his mechanical owl, wings folded.

An archway leads east back into the hall. From the southwest comes the clatter of Writing hammers and the sharp smell of burnt ink.

Horloge looks up as I enter. "Ah, young - young Whotsit!" he bellows, pointing a fat finger in my general direction, though through his thick multi-lensed spectacles I don't think he can quite see where I am. "Look here!" he demands. "Young Whotsit-whoever-you-are! I need some - some of that, you know. Some of that whotsit. A good… of whotsit? Uh-huh? Good? Good." He smiles, then looks back down to his studies, muttering.

Horloge chucks his pet owl under its beak. There is no reaction.

>undo
Scriptorium
[Previous turn undone.]

>l
Scriptorium
The Scriptorium is where the Copying takes place, though it's hard to believe that Copying once meant a team of monks working with carved rubber stamps. It's all done by mechanisms now, of course, like everything else except my chores. There's the massive Gutenberg press on the west wall, and everywhere else is Brother Reloh's Duplicator. Twenty-three Typewriters, all clattering away as though operated by ghosts, all connected by a single Carriage Arm that curves the length of the wall. To leave the room east or northeast I'll have to duck under.

Reloh works on one of the keyboards of the Duplicator, typing furiously. The hammering and punching is almost overwhelming.

The Gutenberg seems to be in the midst of a repair. The Cabinet of Relics next to it is open.

* * *

>switch on duplicator
"Don't," Reloh snaps. So I don't.

>read duplicator
The sheets coming out of the Writers of the Great Duplicator are titled "A Defense of the Faith Against the Strange Motions of the Unsettled Masses". I read a bit. "But for the Irony, that it is Consequentialism which causes Wronged People to accept such Heresy and Bad Thought, I would declare these Bad Thinkers to be Agents of Rust itself. However, it is their Debauchery, their lacks of Precision, both in Morality and Productivity. These things have Led them into Terrible Indecision. "When the teeth of the flock cannot chew, they shall Slip and Spin in most Lonely Individualism." So sayeth…" It doesn't half go on.

>look in press
(the Gutenberg Press)
I find nothing of interest.

>look in cabinet
In the Cabinet of Relics are some press materials and a new gear.

Distantly - but not distantly enough - I can hear the clock and clatter of Drake's boots. The sound's coming from the east.

>undo
Scriptorium
[Previous turn undone.]

>x materials
Typesets and other items, including a full set of new brass gears.

Distantly - but not distantly enough - I can hear the clock and clatter of Drake's boots. The sound's coming from the east.

* * *

>undo
Scriptorium
[Previous turn undone.]

>x geat
I can't see any such thing.

>undo
Scriptorium
[Previous turn undone.]

>x gear
Typesets and other items, including a full set of new brass gears.

Distantly - but not distantly enough - I can hear the clock and clatter of Drake's boots. The sound's coming from the east.

>ne
Library
The Abbey's library is small compared to the one in the Cathedral. There's nothing on the shelves but the key texts: the Principia, the Mechanistica and the Determininium. Only Brother Horloge, the Abbey's Primary Reader ever seems to use them - he's here at the moment, studying at his desk by the poor light coming through the stained glass windows. By his elbow is a fat bunch of keys. On his shoulder is his mechanical owl, wings folded.

An archway leads east back into the hall. From the southwest comes the clatter of Writing hammers and the sharp smell of burnt ink.

Horloge looks up as I enter. "Ah, young - young Whotsit!" he bellows, pointing a fat finger in my general direction, though through his thick multi-lensed spectacles I don't think he can quite see where I am. "Look here!" he demands. "Young Whotsit-whoever-you-are! I need some - some of that, you know. Some of that whotsit. A good… of whotsit? Uh-huh? Good? Good." He smiles, then looks back down to his studies, muttering.

Drake's footsteps echo in from the southwest.

>e
Central Hall
I'm standing in the very centre of the Abbey's Great Hall. It's impossible not to crane my neck here, to gaze up at the ceiling held aloft by buttresses like gigantic oak trees. To think, people built this in the days before proper pulley-transmissions! It must have taken weeks! The hall continues northeast into shadow, and southwest, towards the sunlight, the Yard and above all, the Archbishop.

The vast empty space is filled by the muttering and echo of Holy Mechanisms, and the hiss of the candles as they sweep around their Tracks, providing a little light everywhere but rarely ever enough. I can just make out archways both east and west.

Drake's on patrol, and I can hear him heading this way, from the west.

>n
I can't go that way.

Drake's just off to the west, and he's coming this way!

>ne
Upper Hall
The Great Hall of the Abbey is the biggest room I've seen in my life, running from this end all the way southwest (and it is all the way, I'm never allowed further) to the Great Doors and the Yard outside. If I crane my neck I can see the dark square of the floorboards of my room - the ladder is on one side, to the west. Lights move in and out overhead, from the candles moving on their Holy Tracks. Strong smells float through an archway to the east.

From their niches, the Three Major Saints are watching sternly, keen that I should get out of the Cathedral and talk to the Archbishop as quickly as possible.

>e
Kitchen
If there was ever a proof of the perfection of Clockwork over Nature, it's that the dirtiest and most hectic room in the whole Abbey is its Kitchen. Shelves, walls and floor are covered by machines belching, slicing, steaming, chopping, stirring, boiling, broiling, frying, pureeing … the list goes on. The noise, smell and heat is almost overpowering, and the Cook, who controls this madhouse, can only stand it because he's stone deaf.

In one corner is the only machine I'm allowed to use: the Tea Maker. There's a jar of tea leaf beside it. 

I can escape back into the cool of the Hall to the west. South, through a broad arch, is the Refectory.

Drake's footsteps echo in from the south.

>get gear
Which do I mean, the gear train or the small gear?

>small
While the Cook is distracted - the Cook is always distracted - I pluck the out the worn down gear. Not the sort of repair a clock polisher should be doing!

Looking south, I can see Drake. He's coming this way!

>w
Upper Hall
The Great Hall of the Abbey is the biggest room I've seen in my life, running from this end all the way southwest (and it is all the way, I'm never allowed further) to the Great Doors and the Yard outside. If I crane my neck I can see the dark square of the floorboards of my room - the ladder is on one side, to the west. Lights move in and out overhead, from the candles moving on their Holy Tracks. Strong smells float through an archway to the east.

From their niches, the Three Major Saints are watching sternly, keen that I should get out of the Cathedral and talk to the Archbishop as quickly as possible.

I've got a moment before Drake spots me: he's just appeared, to the east.

* * *

>z
Time passes.

>w
Central Hall
I'm standing in the very centre of the Abbey's Great Hall. It's impossible not to crane my neck here, to gaze up at the ceiling held aloft by buttresses like gigantic oak trees. To think, people built this in the days before proper pulley-transmissions! It must have taken weeks! The hall continues northeast into shadow, and southwest, towards the sunlight, the Yard and above all, the Archbishop.

The vast empty space is filled by the muttering and echo of Holy Mechanisms, and the hiss of the candles as they sweep around their Tracks, providing a little light everywhere but rarely ever enough. I can just make out archways both east and west.

Drake's clattering boots are audible to the west.

>sw
Lower Hall
Looking northeast, the Great Hall of the Abbey stretches away like the belly of some big beast, its bony roof held up by pillars like swallowed trees. The walls are carelessly lit by candles moving through Sacred Tracks suspended in the air. I can just make out the Corridor of Contemplation to the east, and the wider archway to the Scriptorium to the west.

But more importantly, the great Entry - and exit - of the Abbey is to the southwest. And if I'm going to get out of here and talk to the Archbishop that's the only way to go.

But maybe you're starting to see what kind of luck I have. Right there, in the Entry, is Calvin, working on a clock.

* * *

>x gear
(the new gear)
A small brass gear, new cut and freshly blessed by the Filers.

>x gears
Typesets and other items, including a full set of new brass gears.

>undo
Scriptorium
[Previous turn undone.]

>drop gear
(the small gear)
Dropped.

>undo
Scriptorium
[Previous turn undone.]

>undo
Scriptorium
[Previous turn undone.]

>undo
Lower Hall
[Previous turn undone.]

>drop gear
Dropped.

>w
Scriptorium
The Scriptorium is where the Copying takes place, though it's hard to believe that Copying once meant a team of monks working with carved rubber stamps. It's all done by mechanisms now, of course, like everything else except my chores. There's the massive Gutenberg press on the west wall, and everywhere else is Brother Reloh's Duplicator. Twenty-three Typewriters, all clattering away as though operated by ghosts, all connected by a single Carriage Arm that curves the length of the wall. To leave the room east or northeast I'll have to duck under.

Reloh works on one of the keyboards of the Duplicator, typing furiously. The hammering and punching is almost overwhelming.

The Gutenberg seems to be in the midst of a repair. The Cabinet of Relics next to it is open.

>x gear
A small brass gear, new cut and freshly blessed by the Filers.

>get gear
That isn't available.

* * *

>x gear
(the new gear)
A small brass gear, new cut and freshly blessed by the Filers.

>get gear
(the new gear)
"Put that back," Reloh snaps, without looking up. But I don't put it back.

>x gears
Typesets and other items, including a full set of new brass gears.

>get new gear
"Put that back," Reloh snaps, without looking up. But I don't put it back.

>inv
I am carrying:
  a new gear
  a small gear
  my lucky clock key (being worn)
  a rag
  a tumbler

Drake's on patrol, and I can hear him heading this way, from the east.

* * *

>get new gear
"Put that back," Reloh snaps, without looking up. But I don't put it back.

>put new gear in materials
Those can't contain things.

Drake's clattering boots are audible to the east.

>get gear
(the new gear)
I already have that.

I've got a moment before Drake spots me: he's just appeared, to the east.

>ne
Library
The Abbey's library is small compared to the one in the Cathedral. There's nothing on the shelves but the key texts: the Principia, the Mechanistica and the Determininium. Only Brother Horloge, the Abbey's Primary Reader ever seems to use them - he's here at the moment, studying at his desk by the poor light coming through the stained glass windows. By his elbow is a fat bunch of keys. On his shoulder is his mechanical owl, wings folded.

An archway leads east back into the hall. From the southwest comes the clatter of Writing hammers and the sharp smell of burnt ink.

Drake's just off to the southwest, and he's coming this way!

>e
Central Hall
I'm standing in the very centre of the Abbey's Great Hall. It's impossible not to crane my neck here, to gaze up at the ceiling held aloft by buttresses like gigantic oak trees. To think, people built this in the days before proper pulley-transmissions! It must have taken weeks! The hall continues northeast into shadow, and southwest, towards the sunlight, the Yard and above all, the Archbishop.

The vast empty space is filled by the muttering and echo of Holy Mechanisms, and the hiss of the candles as they sweep around their Tracks, providing a little light everywhere but rarely ever enough. I can just make out archways both east and west.

I've got a moment before Drake spots me: he's just appeared, to the west.

>ne
Upper Hall
The Great Hall of the Abbey is the biggest room I've seen in my life, running from this end all the way southwest (and it is all the way, I'm never allowed further) to the Great Doors and the Yard outside. If I crane my neck I can see the dark square of the floorboards of my room - the ladder is on one side, to the west. Lights move in and out overhead, from the candles moving on their Holy Tracks. Strong smells float through an archway to the east.

From their niches, the Three Major Saints are watching sternly, keen that I should get out of the Cathedral and talk to the Archbishop as quickly as possible.

* * *

>get cup
I pick up the empty cup from its place beside by Brother Horloge's hourglass.

>z
Time passes.

>w
Just in time, I see Drake's there. I hang back, to let him move on.

* * *

>ne
Upper Hall
The Great Hall of the Abbey is the biggest room I've seen in my life, running from this end all the way southwest (and it is all the way, I'm never allowed further) to the Great Doors and the Yard outside. If I crane my neck I can see the dark square of the floorboards of my room - the ladder is on one side, to the west. Lights move in and out overhead, from the candles moving on their Holy Tracks. Strong smells float through an archway to the east.

From their niches, the Three Major Saints are watching sternly, keen that I should get out of the Cathedral and talk to the Archbishop as quickly as possible.

* * *

>put cup in brace
I can't see any such thing.

>put cup in bracket
Done.

The cook bustles past me, to tighten the oven.

Drake's footsteps echo in from the south.

>get leaves
(the tea leaves)
I scoop up a handful of tea leaves.

Looking south, I can see Drake. He's coming this way!

>w
Upper Hall
The Great Hall of the Abbey is the biggest room I've seen in my life, running from this end all the way southwest (and it is all the way, I'm never allowed further) to the Great Doors and the Yard outside. If I crane my neck I can see the dark square of the floorboards of my room - the ladder is on one side, to the west. Lights move in and out overhead, from the candles moving on their Holy Tracks. Strong smells float through an archway to the east.

From their niches, the Three Major Saints are watching sternly, keen that I should get out of the Cathedral and talk to the Archbishop as quickly as possible.

I've got a moment before Drake spots me: he's just appeared, to the east.

>w
Rickety Stair
I'm in one corner of the Great Hall, just by the foot of the ladder up to my room. There's a note attached to it, asking Amble the caretaker not to put it back in the shed just yet.

* * *

>e
Kitchen
If there was ever a proof of the perfection of Clockwork over Nature, it's that the dirtiest and most hectic room in the whole Abbey is its Kitchen. Shelves, walls and floor are covered by machines belching, slicing, steaming, chopping, stirring, boiling, broiling, frying, pureeing … the list goes on. The noise, smell and heat is almost overpowering, and the Cook, who controls this madhouse, can only stand it because he's stone deaf.

In one corner is the only machine I'm allowed to use: the Tea Maker. There's a jar of tea leaf beside it. In the bracket of the machine is a tea cup.

I can escape back into the cool of the Hall to the west. South, through a broad arch, is the Refectory.

>put leaves in bracket
(the handful of tea leaves in the bracket)
The bracket's right and proper function is to hold a teacup only.

The cook pushes past me, to respring the crumb-sucker.

>undo
Kitchen
[Previous turn undone.]

>put leaves in basket
(the handful of tea leaves in the basket)
The basket's now filled with tea leaves.

>turn spigot
The spigot releases a thin dribble of water into the kettle. Across the room, the clouds coming from the steamer suddenly thin out and the Cook pauses to give me the most evil of evil stars. I turn the spigot closed again.

>pull lever
The lever moves without resistance. It's been long enough since breakfast, clearly, that the spring has wound down.

Drake's clattering boots are audible to the south.

>undo
Kitchen
[Previous turn undone.]

>wind key
(my lucky clock key)
Nothing obvious happens.

Drake's on patrol, and I can hear him heading this way, from the south.

>undo
Kitchen
[Previous turn undone.]

>wind tea key
A few turns and the spring is fully wound.

Drake's on patrol, and I can hear him heading this way, from the south.

>put new gear in gear train
The gear train forms a perfect snake from the lever, over the semi-circular bracket and into the innards of the machine.

Drake's just off to the south, and he's coming this way!

>w
Upper Hall
The Great Hall of the Abbey is the biggest room I've seen in my life, running from this end all the way southwest (and it is all the way, I'm never allowed further) to the Great Doors and the Yard outside. If I crane my neck I can see the dark square of the floorboards of my room - the ladder is on one side, to the west. Lights move in and out overhead, from the candles moving on their Holy Tracks. Strong smells float through an archway to the east.

From their niches, the Three Major Saints are watching sternly, keen that I should get out of the Cathedral and talk to the Archbishop as quickly as possible.

Looking east, I can see Drake. He's coming this way!

* * *

>pull lever
The gear-train whirrs into life, swinging the kettle across inside the machine. Its base knocks open the gas-pipe tap. A jet of gas hisses out, blowing up a tiny sail attached by thread to the flint-iron. The burner is quickly alight.

* * *

>get gear
(the new gear)
"Put that back," Reloh snaps, without looking up. But I don't put it back.

>trace
[Trace on.]

>get gear
[Parsing for the verb 'get' (5 lines)]
[line 0 * 'out' / 'off' / 'up' -> Exit]
[line 1 * multi -> Take]
[Line successfully parsed]
(the small gear)
I already have that.

* * *

>get gear
(the new gear)
"Put that back," Reloh snaps, without looking up. But I don't put it back.

>x new
A small brass gear, new cut and freshly blessed by the Filers.

* * *

>get gear
(the new gear)
"Put that back," Reloh snaps, without looking up. But I don't put it back.

>rules
Rules tracing now switched on. Type "rules off" to switch it off again, or "rules all" to include even rules which do not apply.

* * *

>rules all
Rules tracing now switched to "all". Type "rules off" to switch it off again.

* * *

>get gear
(the new gear)
"Put that back," Reloh snaps, without looking up. But I don't put it back.

>get new gear
I already have that.

* * *

>x new gear
Typesets and other items, including a full set of new brass gears.

>look in cabinet
Typesets and other items, including a full set of new brass gears.

>x new gears
Typesets and other items, including a full set of new brass gears.

>ne
Library
The Abbey's library is small compared to the one in the Cathedral. There's nothing on the shelves but the key texts: the Principia, the Mechanistica and the Determininium. Only Brother Horloge, the Abbey's Primary Reader ever seems to use them - he's here at the moment, studying at his desk by the poor light coming through the stained glass windows. By his elbow is a fat bunch of keys. On his shoulder is his mechanical owl, wings folded.

An archway leads east back into the hall. From the southwest comes the clatter of Writing hammers and the sharp smell of burnt ink.

Horloge looks up as I enter. "Ah, young - young Whotsit!" he bellows, pointing a fat finger in my general direction, though through his thick multi-lensed spectacles I don't think he can quite see where I am. "Look here!" he demands. "Young Whotsit-whoever-you-are! I need some - some of that, you know. Some of that whotsit. A good… of whotsit? Uh-huh? Good? Good." He smiles, then looks back down to his studies, muttering.

>e
Just in time, I see Drake's there. I hang back, to let him move on.

Distantly - but not distantly enough - I can hear the clock and clatter of Drake's boots. The sound's coming from the southwest.

>e
Central Hall
I'm standing in the very centre of the Abbey's Great Hall. It's impossible not to crane my neck here, to gaze up at the ceiling held aloft by buttresses like gigantic oak trees. To think, people built this in the days before proper pulley-transmissions! It must have taken weeks! The hall continues northeast into shadow, and southwest, towards the sunlight, the Yard and above all, the Archbishop.

The vast empty space is filled by the muttering and echo of Holy Mechanisms, and the hiss of the candles as they sweep around their Tracks, providing a little light everywhere but rarely ever enough. I can just make out archways both east and west.

Drake's on patrol, and I can hear him heading this way, from the west.

>ne
Upper Hall
The Great Hall of the Abbey is the biggest room I've seen in my life, running from this end all the way southwest (and it is all the way, I'm never allowed further) to the Great Doors and the Yard outside. If I crane my neck I can see the dark square of the floorboards of my room - the ladder is on one side, to the west. Lights move in and out overhead, from the candles moving on their Holy Tracks. Strong smells float through an archway to the east.

From their niches, the Three Major Saints are watching sternly, keen that I should get out of the Cathedral and talk to the Archbishop as quickly as possible.

* * *

>get small
While the Cook is distracted - the Cook is always distracted - I pluck the out the worn down gear. Not the sort of repair a clock polisher should be doing!

The cook knocks past me, to unclip the grater.

Drake's clattering boots are audible to the south.

>w
Upper Hall
The Great Hall of the Abbey is the biggest room I've seen in my life, running from this end all the way southwest (and it is all the way, I'm never allowed further) to the Great Doors and the Yard outside. If I crane my neck I can see the dark square of the floorboards of my room - the ladder is on one side, to the west. Lights move in and out overhead, from the candles moving on their Holy Tracks. Strong smells float through an archway to the east.

From their niches, the Three Major Saints are watching sternly, keen that I should get out of the Cathedral and talk to the Archbishop as quickly as possible.

Drake's on patrol, and I can hear him heading this way, from the east.

>sw
Central Hall
I'm standing in the very centre of the Abbey's Great Hall. It's impossible not to crane my neck here, to gaze up at the ceiling held aloft by buttresses like gigantic oak trees. To think, people built this in the days before proper pulley-transmissions! It must have taken weeks! The hall continues northeast into shadow, and southwest, towards the sunlight, the Yard and above all, the Archbishop.

The vast empty space is filled by the muttering and echo of Holy Mechanisms, and the hiss of the candles as they sweep around their Tracks, providing a little light everywhere but rarely ever enough. I can just make out archways both east and west.

Drake's clattering boots are audible to the northeast.

>e
West Refectory
I spend some of my time here, eating at one of the two long tables. I spend even more serving the monks. Each of them has their own seat, marked by a little brass hourglass, and if the twenty or so I can see here weren't enough (which they aren't), there's more to the east, where the Refectory continues. Back west is the archway to the Great Hall.

On the table is a single empty teacup, left over from breakfast.

* * *

>get cup
I pick up the empty cup from its place beside by Brother Horloge's hourglass.

>w
Just in time, I see Drake's there. I hang back, to let him move on.

>w
Central Hall
I'm standing in the very centre of the Abbey's Great Hall. It's impossible not to crane my neck here, to gaze up at the ceiling held aloft by buttresses like gigantic oak trees. To think, people built this in the days before proper pulley-transmissions! It must have taken weeks! The hall continues northeast into shadow, and southwest, towards the sunlight, the Yard and above all, the Archbishop.

The vast empty space is filled by the muttering and echo of Holy Mechanisms, and the hiss of the candles as they sweep around their Tracks, providing a little light everywhere but rarely ever enough. I can just make out archways both east and west.

Drake's footsteps echo in from the west.

>sw
Lower Hall
Looking northeast, the Great Hall of the Abbey stretches away like the belly of some big beast, its bony roof held up by pillars like swallowed trees. The walls are carelessly lit by candles moving through Sacred Tracks suspended in the air. I can just make out the Corridor of Contemplation to the east, and the wider archway to the Scriptorium to the west.

But more importantly, the great Entry - and exit - of the Abbey is to the southwest. And if I'm going to get out of here and talk to the Archbishop that's the only way to go.

But maybe you're starting to see what kind of luck I have. Right there, in the Entry, is Calvin, working on a clock.

* * *

>get new gear
"Put that back," Reloh snaps, without looking up. But I don't put it back.

>ne
Library
The Abbey's library is small compared to the one in the Cathedral. There's nothing on the shelves but the key texts: the Principia, the Mechanistica and the Determininium. Only Brother Horloge, the Abbey's Primary Reader ever seems to use them - he's here at the moment, studying at his desk by the poor light coming through the stained glass windows. By his elbow is a fat bunch of keys. On his shoulder is his mechanical owl, wings folded.

An archway leads east back into the hall. From the southwest comes the clatter of Writing hammers and the sharp smell of burnt ink.

>e
Central Hall
I'm standing in the very centre of the Abbey's Great Hall. It's impossible not to crane my neck here, to gaze up at the ceiling held aloft by buttresses like gigantic oak trees. To think, people built this in the days before proper pulley-transmissions! It must have taken weeks! The hall continues northeast into shadow, and southwest, towards the sunlight, the Yard and above all, the Archbishop.

The vast empty space is filled by the muttering and echo of Holy Mechanisms, and the hiss of the candles as they sweep around their Tracks, providing a little light everywhere but rarely ever enough. I can just make out archways both east and west.

Drake's on patrol, and I can hear him heading this way, from the northeast.

>e
West Refectory
I spend some of my time here, eating at one of the two long tables. I spend even more serving the monks. Each of them has their own seat, marked by a little brass hourglass, and if the twenty or so I can see here weren't enough (which they aren't), there's more to the east, where the Refectory continues. Back west is the archway to the Great Hall.

>w
I catch the sound of hobnailed boots. Drake's heading this way! I'd better wait, and let him pass.

* * *

>e
Kitchen
If there was ever a proof of the perfection of Clockwork over Nature, it's that the dirtiest and most hectic room in the whole Abbey is its Kitchen. Shelves, walls and floor are covered by machines belching, slicing, steaming, chopping, stirring, boiling, broiling, frying, pureeing … the list goes on. The noise, smell and heat is almost overpowering, and the Cook, who controls this madhouse, can only stand it because he's stone deaf.

In one corner is the only machine I'm allowed to use: the Tea Maker. There's a jar of tea leaf beside it. 

I can escape back into the cool of the Hall to the west. South, through a broad arch, is the Refectory.

The cook scurries past me, to thump the crumb-sucker.

>put cup in bracket
Done.

Drake's clattering boots are audible to the south.

>put new gear in train
The gear train forms a perfect snake from the lever, over the semi-circular bracket and into the innards of the machine.

The cook pushes past me, to wind the broiler.

I've got a moment before Drake spots me: he's just appeared, to the south.

>w
Upper Hall
The Great Hall of the Abbey is the biggest room I've seen in my life, running from this end all the way southwest (and it is all the way, I'm never allowed further) to the Great Doors and the Yard outside. If I crane my neck I can see the dark square of the floorboards of my room - the ladder is on one side, to the west. Lights move in and out overhead, from the candles moving on their Holy Tracks. Strong smells float through an archway to the east.

From their niches, the Three Major Saints are watching sternly, keen that I should get out of the Cathedral and talk to the Archbishop as quickly as possible.

Looking east, I can see Drake. He's coming this way!

* * *

>put jar in basket
(first taking some tea from the jar)
The basket's now filled with tea leaves.

The cook bustles past me, to thump the steamer.

>put gear in machine
(the new gear in the Tea Machine)
The gear train forms a perfect snake from the lever, over the semi-circular bracket and into the innards of the machine.

>new
That's not a verb I recognize.

>put cup in machine
(the Tea Machine)
I need to be holding the teacup before I can put it into something else.

The cook scurries past me, to wind the crumb-sucker.

Drake's footsteps echo in from the south.

>undo
Kitchen
[Previous turn undone.]

>pull lever
The Cook gawps, then troops over and belts me around the head. He points firmly at the kettle in the middle of the machine - the empty kettle in the middle of the machine - then stalks back over to his chopping machine.

Drake's on patrol, and I can hear him heading this way, from the south.

>undo
Kitchen
[Previous turn undone.]

>turn on spigor
I can't see any such thing.

>oops spigot
I only understood you as far as wanting to turn the spigot.

>turn on spigot
The spigot releases a thin dribble of water into the kettle. Across the room, the clouds coming from the steamer suddenly thin out and the Cook pauses to give me the most evil of evil stars. I turn the spigot closed again.

The cook scurries past me, to unclip the masher.

Drake's on patrol, and I can hear him heading this way, from the south.

>pull lever
The lever moves without resistance. It's been long enough since breakfast, clearly, that the spring has wound down.

The cook bustles past me, to respring the steamer.

Drake's just off to the south, and he's coming this way!

>w
Upper Hall
The Great Hall of the Abbey is the biggest room I've seen in my life, running from this end all the way southwest (and it is all the way, I'm never allowed further) to the Great Doors and the Yard outside. If I crane my neck I can see the dark square of the floorboards of my room - the ladder is on one side, to the west. Lights move in and out overhead, from the candles moving on their Holy Tracks. Strong smells float through an archway to the east.

From their niches, the Three Major Saints are watching sternly, keen that I should get out of the Cathedral and talk to the Archbishop as quickly as possible.

Looking east, I can see Drake. He's coming this way!

* * *

>e
Kitchen
If there was ever a proof of the perfection of Clockwork over Nature, it's that the dirtiest and most hectic room in the whole Abbey is its Kitchen. Shelves, walls and floor are covered by machines belching, slicing, steaming, chopping, stirring, boiling, broiling, frying, pureeing … the list goes on. The noise, smell and heat is almost overpowering, and the Cook, who controls this madhouse, can only stand it because he's stone deaf.

In one corner is the only machine I'm allowed to use: the Tea Maker. There's a jar of tea leaf beside it. In the bracket of the machine is a teacup. 

I can escape back into the cool of the Hall to the west. South, through a broad arch, is the Refectory.

The cook knocks past me, to thump the masher.

>wind key
(the tea machine key)
A few turns and the spring is fully wound.

>undo
Kitchen
[Previous turn undone.]

>wind tea machine key
A few turns and the spring is fully wound.

The cook knocks past me, to unclip the oven.

>pull lever
The gear-train whirrs into life, swinging the kettle across inside the machine. Its base knocks open the gas-pipe tap. A jet of gas hisses out, blowing up a tiny sail attached by thread to the flint-iron. The burner is quickly alight.

The cook scurries past me, to respring the whisker.

>x burner
The burner is firing.

Drake's footsteps echo in from the south.

>x burner
The burner is firing.

The cook pushes past me, to tighten the grater.

Looking south, I can see Drake. He's coming this way!

>undo
Kitchen
[Previous turn undone.]

>undo
Kitchen
[Previous turn undone.]

>x flame
The burner is firing.

The cook bustles past me, to wind the crumb-sucker.

Drake's footsteps echo in from the south.

* * *

>wind key
(the tea machine key)
A few turns and the spring is fully wound.

>pull lever
The gear train whirrs into life, swinging the kettle across inside the machine. Its base knocks open the gas-pipe tap. A jet of gas hisses out, blowing up a tiny sail attached by thread to the flint-iron. The burner is quickly alight.

The cook bustles past me, to unclip the oven.

>x burner
The burner is firing.

After a minute or so, steam begins to rise from the kettle. This steam collects on a fine gauze over the kettle, which slowly weighs down on a thin metal strut. Eventually, the pressure is enough to flip a counterweight, and the gauze tilts, pushes the kettle onto its side. Boiling water pours from the spout and into the basket of tea leaves. As the kettle empties, its weight shifts and it swings back. A pin on one side knocks closed the gas pipe.

Drake's clattering boots are audible to the south.

>x burner
The burner is cooling.

The basket slows filters tea into the waiting cup. Meanwhile, the slowing gears move the kettle back to its original position below the spigot, and the water on the gauze sheet evaporates away. All is restored: "Every cog comes full circle," as they say.

The cook knocks past me, to wind the crumb-sucker.

Drake's just off to the south, and he's coming this way!

>z
Time passes.

The lever springs back. The tea is finished. In a final convulsion, the machine spits the used tea leaves out the back and into a composter duct, ready to be fed to the cows that provided the gas… It's certainly neat.

"Wren!" Drake exclaims. He wallops me on the arm. "I thought I told you to stay in your room?" He doesn't wait for an excuse before I'm dragged off to the ladder. Then he waits - and wallops me - until I give in and climb all the way back up.

Attic Room
This isn't really an attic. It isn't really a room either. It's a couple of floorboards laid across some roof rafters right in the ceiling of the Abbey. There's enough floor-space for a cot and a laundry crate, but I have to be careful not to roll out of bed, because if I do, the thick cobwebs all around aren't going to stop me from falling….

A little hole in the ceiling provides some sunlight: and when it rains, it means I can wash my hair, too. It's right above the rickety ladder down to the ground (and that means the ladder is starting to rot and bend).

That was careless, getting caught. But I can still make it to the Cathedral. I'll just have to be more cunning this time. Remember, Wren, it's easy: the whole world runs on clockwork. Just a matter of staying ahead of the biting teeth.

* * *

>get tea
(the cup of tea)
I lift the cup carefully from the machine. The Cook turns and for the first time seems to notice me. He looks furious. "And where you thin" you go wi" tha"?" he demands. "Wait. Wa"."

After a bit of tidying, he finds a button to press. A machine coughs and wheezes, and eventually a small half-slice of lemon squeezes from a slot. The Cook snatches it and drops it into my tea cup. "Ri" you are," he says, and then waves me away.

The cook bustles past me, to tighten the whisker.

>showme
Kitchen - room
    myself - person
        small gear
        my lucky clock key (worn)
        rag
        tumbler - open container
    Cook - man
    machines
    tea leaves - open container
        tea leaves
    Tea Machine
        spigot (part of Tea Machine) - device
        kettle (part of Tea Machine) - fake container
        burner (part of Tea Machine) - internal gubbin
        flint-iron (part of Tea Machine) - internal gubbin
        basket (part of Tea Machine) - fake container
        bracket (part of Tea Machine) - open container
        gear train (part of Tea Machine)
            new gear (part of gear train)
        tea machine key (part of Tea Machine)
        tea machine lever (part of Tea Machine)
            cup of tea - fake container

* * *

>get tea
(the cup of tea)
I lift the cup carefully from the machine. The Cook turns and for the first time seems to notice me. He looks furious. "And where you thin" you go wi" tha"?" he demands. "Wait. Wa"."

After a bit of tidying, he finds a button to press. A machine coughs and wheezes, and eventually a small half-slice of lemon squeezes from a slot. The Cook snatches it and drops it into my tea cup. "Ri" you are," he says, and then waves me away.

The cook bustles past me, to tighten the whisker.

>x tea
(the cup of tea)
A steaming cup of freshly-brewed tea.

The cook knocks past me, to unclip the grater.

>put tea on machine
(the cup of tea on the Tea Machine)
Putting things on the Tea Machine would achieve nothing.

Drake's on patrol, and I can hear him heading this way, from the south.

>put tea in tea
Which do I mean, the jar of tea leaves, the loose tea leaves (inside the jar), the Tea Machine, the tea machine key, the tea machine lever or the cup of tea?

>cup
(the cup of tea)
Don't. That would spoil the tea.

The cook bustles past me, to tighten the oven.

I've got a moment before Drake spots me: he's just appeared, to the south.

>undo
Kitchen
[Previous turn undone.]

>touch tea
(the cup of tea)
I feel nothing unexpected.

I've got a moment before Drake spots me: he's just appeared, to the south.

>w
Upper Hall
The Great Hall of the Abbey is the biggest room I've seen in my life, running from this end all the way southwest (and it is all the way, I'm never allowed further) to the Great Doors and the Yard outside. If I crane my neck I can see the dark square of the floorboards of my room - the ladder is on one side, to the west. Lights move in and out overhead, from the candles moving on their Holy Tracks. Strong smells float through an archway to the east.

From their niches, the Three Major Saints are watching sternly, keen that I should get out of the Cathedral and talk to the Archbishop as quickly as possible.

Drake's just off to the east, and he's coming this way!

>s
I can't go that way.

Drake looks like he's swallowed a bee. Not only have I disobeyed him, but I've done it twice. "I'm going to have your skin," he hisses into in my ear. "I'm going to use it as a cloak comes winter. Understand?" With that he drags me back off to my attic. This time, I can barely climb the stairs.

Attic Room
This isn't really an attic. It isn't really a room either. It's a couple of floorboards laid across some roof rafters right in the ceiling of the Abbey. There's enough floor-space for a cot and a laundry crate, but I have to be careful not to roll out of bed, because if I do, the thick cobwebs all around aren't going to stop me from falling….

A little hole in the ceiling provides some sunlight: and when it rains, it means I can wash my hair, too. It's right above the rickety ladder down to the ground (and that means the ladder is starting to rot and bend).

A quick pause for breath and… right then. I'm ready. I'm going to get out of the Abbey somehow, and warn the Archbishop. And I won't give up till I've got there!

>undo
Upper Hall
[Previous turn undone.]

>sw
Central Hall
I'm standing in the very centre of the Abbey's Great Hall. It's impossible not to crane my neck here, to gaze up at the ceiling held aloft by buttresses like gigantic oak trees. To think, people built this in the days before proper pulley-transmissions! It must have taken weeks! The hall continues northeast into shadow, and southwest, towards the sunlight, the Yard and above all, the Archbishop.

The vast empty space is filled by the muttering and echo of Holy Mechanisms, and the hiss of the candles as they sweep around their Tracks, providing a little light everywhere but rarely ever enough. I can just make out archways both east and west.

Looking northeast, I can see Drake. He's coming this way!

>w
Library
The Abbey's library is small compared to the one in the Cathedral. There's nothing on the shelves but the key texts: the Principia, the Mechanistica and the Determininium. Only Brother Horloge, the Abbey's Primary Reader ever seems to use them - he's here at the moment, studying at his desk by the poor light coming through the stained glass windows. By his elbow is a fat bunch of keys. On his shoulder is his mechanical owl, wings folded.

An archway leads east back into the hall. From the southwest comes the clatter of Writing hammers and the sharp smell of burnt ink.

Horloge chucks his pet owl under its beak. There is no reaction.

>empty tea
After all that? No way.

Drake's footsteps echo in from the southwest.

>get slice
Don't. That would spoil the tea.

Looking southwest, I can see Drake. He's coming this way!

* * *

>empty tea
After all that? No way.

Drake's footsteps echo in from the southwest.

>undo
Library
[Previous turn undone.]

>pour tea onto desk
I only understood you as far as wanting to pour the cup of tea.

>pour cup of tea
I only understood you as far as wanting to pour the cup of tea.

>pour cup
After all that? No way.

Drake's clattering boots are audible to the southwest.

>undo
Library
[Previous turn undone.]

* * *

>put tea on table
I set the cup down beside Brother Horloge's elbow. "Excellent, there," he says, beaming, nostrils twitching. "Such a smell! The finest!" He lifts the cup, takes a sip and smacks his lips. "It's the slight metallic tang that really gives it the whotsit," he adds. His eyes half-close in calm delight.

Horloge chucks his pet owl under its beak. There is no reaction.

Drake's on patrol, and I can hear him heading this way, from the southwest.

>ask horloge about tea
"You like your tea?" I ask.

"Young Whotsit, it's about as fine as it could be," he replies cheerfully.

He's so enthusiastic as he talks that he knocks his keys onto the floor, though he doesn't seem to notice.

Horloge's finger shakes terribly as he traces the Holy Lines across the sheet.

Looking southwest, I can see Drake. He's coming this way!

>ask horloge about whotsit
"A whotsit?" I ask.

"Yes, quite right," he replies, shaking a finger. "Nice and hot."

Drake looks like he's swallowed a bee. Not only have I disobeyed him, but I've done it twice. "I'm going to have your skin," he hisses into in my ear. "I'm going to use it as a cloak comes winter. Understand?" With that he drags me back off to my attic. This time, I can barely climb the stairs.

Attic Room
This isn't really an attic. It isn't really a room either. It's a couple of floorboards laid across some roof rafters right in the ceiling of the Abbey. There's enough floor-space for a cot and a laundry crate, but I have to be careful not to roll out of bed, because if I do, the thick cobwebs all around aren't going to stop me from falling….

A little hole in the ceiling provides some sunlight: and when it rains, it means I can wash my hair, too. It's right above the rickety ladder down to the ground (and that means the ladder is starting to rot and bend).

A quick pause for breath and… right then. I'm ready. I'm going to get out of the Abbey somehow, and warn the Archbishop. And I won't give up till I've got there!

* * *

>ask horloge about tea
"You like your tea?" I ask.

"Young Whotsit, it's about as fine as it could be," he replies cheerfully.

He's so enthusiastic as he talks that he knocks his keys onto the floor, though he doesn't seem to notice.

Horloge's finger shakes terribly as he traces the Holy Lines across the sheet.

Looking southwest, I can see Drake. He's coming this way!

>e
Central Hall
I'm standing in the very centre of the Abbey's Great Hall. It's impossible not to crane my neck here, to gaze up at the ceiling held aloft by buttresses like gigantic oak trees. To think, people built this in the days before proper pulley-transmissions! It must have taken weeks! The hall continues northeast into shadow, and southwest, towards the sunlight, the Yard and above all, the Archbishop.

The vast empty space is filled by the muttering and echo of Holy Mechanisms, and the hiss of the candles as they sweep around their Tracks, providing a little light everywhere but rarely ever enough. I can just make out archways both east and west.

I've got a moment before Drake spots me: he's just appeared, to the west.

* * *

>undo
Scriptorium
[Previous turn undone.]

>ne
Library
The Abbey's library is small compared to the one in the Cathedral. There's nothing on the shelves but the key texts: the Principia, the Mechanistica and the Determininium. Only Brother Horloge, the Abbey's Primary Reader ever seems to use them - he's here at the moment, studying at his desk by the poor light coming through the stained glass windows. On the floor by his feet is a fat bunch of keys. On his shoulder is his mechanical owl, wings folded.

An archway leads east back into the hall. From the southwest comes the clatter of Writing hammers and the sharp smell of burnt ink.

On the wheeled table is a cup of tea (in which is a slice of lemon).

>get tea
Taken.

>put tea on table
I set the cup down beside Brother Horloge's elbow. "Excellent, there," he says, beaming, nostrils twitching. "Such a smell! The finest!" He lifts the cup, takes a sip and smacks his lips. "It's the slight metallic tang that really gives it the whotsit," he adds. His eyes half-close in calm delight.

>get tea
Taken.

>put tea on table
I set the cup down beside Brother Horloge's elbow. "Excellent, there," he says, beaming, nostrils twitching. "Such a smell! The finest!" He lifts the cup, takes a sip and smacks his lips. "It's the slight metallic tang that really gives it the whotsit," he adds. His eyes half-close in calm delight.

Drake's clattering boots are audible to the southwest.

>get keys
They're hardly portable.

Brother Horloge mumbles as he traces over the sheet of manuscript.

Drake's just off to the southwest, and he's coming this way!

* * *

>fill tumbler with clock
I need to be holding Gubbler's Grandfather clock before I can put it into something else.

"And don't come out till that clock's shining!" shouts Drake from the hall.

"Yeah," Calvin says. "It's got to look as good as if we did it!"

"Idiot," Drake mutters. "Come on."

Their voices disappear down the hall.

>inv
I am carrying:
  my lucky clock key (being worn)
  a rag
  a tumbler
    a small amount of polish

The grandfather clock ticks off a minute with a stately thunk. Quickly, I make the sign of the winding gear.

>fill tumbler with rag
Done.

From the hallway outside comes the echo of voices. Too shaky to be Calvin or Drake. More like - oh, no. It's the Abbot, coming back to his room. And if he finds me here, then my springs won't be worth the spindles they're sprung to…

>undo
Abbot's Quarters
[Previous turn undone.]

>put rag in tumbler
Done.

From the hallway outside comes the echo of voices. Too shaky to be Calvin or Drake. More like - oh, no. It's the Abbot, coming back to his room. And if he finds me here, then my springs won't be worth the spindles they're sprung to…

>undo
Abbot's Quarters
[Previous turn undone.]

* * *

>fill tumbler with rag
Done.

From the hallway outside comes the echo of voices. Too shaky to be Calvin or Drake. More like - oh, no. It's the Abbot, coming back to his room. And if he finds me here, then my springs won't be worth the spindles they're sprung to…

>enter clock
"We'll talk in here," I hear the Abbot saying, from right outside the door. "More private. More quiet. Much better." The old man steps inside the room, followed by a tall figure in grey. In the last tick before his old eyes can see me, I dive inside the gigantic clock case and pull closed the door.

Inside Clock Case
As the phrase goes, I'm stuck between a rack and a gear-trace; except here I'm in the narrow gap between the clock case door and the heavy swinging penduluum behind. And if that hit me, and disrupted the holy timings… well, there's no way they wouldn't notice when the clock-hands stopped moving, let's just say.

A little light shines in through the keyhole, which is almost covered by the Abbot's spare robe.

Oh, no… That click outside was the sound of the Abbot closing the door. Looks like he - and the grey figure I glimpsed with him - are going to be here for a while…

>listen with tumbler
Oh… well, then. I tip out the last of the polish onto the floor of the clock. At least that part will shine.

I pour the rag onto the floor.

I put the glass tumbler carefully against the door, then lean down to press my ear against it. Fantastic! I can hear much more clearly now!

"I told you now didn't I tell you?" old Abbot Gubbler is saying, plaintively. "Here? Why here? You shouldn't have come here."

The Figure says something in reply. With the glass, I can hear quite clearly. That was a good idea. "We have been disappointed with your failure. The cause and effect principle, Abbot. Such failure must bring consequences."

>x figure
The glimpse I caught earlier was a tall - man? - wearing a suit of grey leather and a long flowing cape. Now I can't see him at all - it's almost as though he knows I'm hiding, and he's avoiding the keyhole's line of sight.

"But these things, these things are not always tick-tock, they never are," the old man replies. His voice is quivering, quite different from the steady drone he has when intoning in Chapel. "The - item you asked about - it's in the Vaults, you see? The Vaults. Even if I could get in, I …"

"Your excuses we find disappointing. Very disappointing. More of this and, Abbot, we may need to unslip your gears completely."

>get rag
Taken.

The Abbot is spluttering and choking. You've seen him like this only once, when as a young initiate you dropped and smashed an altimeter right before the Archbishop was due to visit.

The Figure continues. "Clearly you're too old to steal the item for us. We have a better mechanism for obtaining it. But you must provide us with the opportunity. Is that understood?"

The Abbot nods violently, shaking out agreement the way I might beat dirt from a duster. "My money?" he asks.

>out
You've got a spring missing if you think I can slip out, unnoticed, or come up with a decent excuse as to why I've been hiding in the Abbot's grandfather. No, I'm staying put and hoping nothing happens to make the old man need to change his clothes.

There's the clink, of a pouch of golden minutes. A heavy pouch. The Figure, paying the Abbot…? Then suddenly, there's a third voice. "Sorry, Father, to interrupt, but you said…"

It's a monk of the Abbey. "Get out!" the Abbot screeches. His bearing's lost its oil, it seems. "Get out, get out!"

"But Father," the monk continues, "it's time, you know. You told me to tell you when it was time."

"Oh! Of course of course," he mumbles. "I'll… We'll continue this discussion later, then," he says, to the Figure.

"We certainly will," the Figure replies.

The Abbot leaves, and that leaves me alone, inside this clock, with the stranger outside. He's coming nearer… I can hear his fingers on the door of the case! I must have nudged the penduluum, he must have seen the clock-hands quiver… but then, there's the swish of his cloak as he moves away, and the click as the door closes. Phew.

>look through keyhole
Through the keyhole I can see the corner of the Abbot's desk, but the Abbot and the Figure have gone.

>out
I spill gratefully out of the clock, gasping for breath as though I've been underwater. I've just been holding it in, of course. As what I've heard - well, I probably shouldn't have, and the quicker I can get out of here, the better.

Abbot's Quarters
If I thought Abbots lived in luxury, then I was dead wrong. Even my attic's cosier than this. The Abbot's got no furniture at all, except a desk and a cot, and no decoration except for a bust of St. Newton. None of the axle-mounted bevelled mobiles I was expecting. There's barely even any sunlight: one thin window to catch the sun-rise, opposite the door to the hallway back west.

St. Newton is staring at the Abbot's unpolished Grandfather clock with a severe frown.

* * *

>e
Kitchen
If there was ever a proof of the perfection of Clockwork over Nature, it's that the dirtiest and most hectic room in the whole Abbey is its Kitchen. Shelves, walls and floor are covered by machines belching, slicing, steaming, chopping, stirring, boiling, broiling, frying, pureeing … the list goes on. The noise, smell and heat is almost overpowering, and the Cook, who controls this madhouse, can only stand it because he's stone deaf.

I can escape back into the cool of the Hall to the west. South, through a broad arch, is the Refectory.

>s
East Refectory
The eastern end of the long Refectory is given over in part to the tables lined with brass hourglasses, but in the other half there's nothing but the enormous Refectory Clock. It's an impressive thing, so big because it only needs winding once a year, despite all the gongs, cymbals, tubes and bells that strike when dinner time comes around. Right now, the clock is showing the time at just after quarter past three.

Pungent smells drift in from the kitchen to the north. On the east wall is the small green door to the Abbey's herb garden.

Distantly - but not distantly enough - I can hear the clock and clatter of Drake's boots. The sound's coming from the west.

* * *

>unlock clock
(with my lucky clock key)
That doesn't seem to be something I can unlock.

"And don't come out till that clock's shining!" shouts Drake from the hall.

"Yeah," Calvin says. "It's got to look as good as if we did it!"

"Idiot," Drake mutters. "Come on."

Their voices disappear down the hall.

>inv
I am carrying:
  my lucky clock key (being worn)
  a rag
  a tumbler
    a small amount of polish

The grandfather clock ticks off a minute with a stately thunk. Quickly, I make the sign of the winding gear.

* * *

>unlock clock
(with my lucky clock key)
That doesn't seem to be something I can unlock.

"And don't come out till that clock's shining!" shouts Drake from the hall.

"Yeah," Calvin says. "It's got to look as good as if we did it!"

"Idiot," Drake mutters. "Come on."

Their voices disappear down the hall.

>unlock clock with my key
That doesn't seem to be something I can unlock.

The grandfather clock ticks off a minute with a stately thunk. Quickly, I make the sign of the winding gear.

* * *

>unlock clock
(with my lucky clock key)
That doesn't seem to be something I can unlock.

"And don't come out till that clock's shining!" shouts Drake from the hall.

"Yeah," Calvin says. "It's got to look as good as if we did it!"

"Idiot," Drake mutters. "Come on."

Their voices disappear down the hall.

>undo
Abbot's Quarters
[Previous turn undone.]

* * *

>rules
Rules tracing now switched on. Type "rules off" to switch it off again, or "rules all" to include even rules which do not apply.

>undo
[You can't "undo" what hasn't been done!]

>unlock clock
[Rule "Rule for supplying a missing second noun while unlocking" applies.]
(with My lucky clock key)
That isn't available.

[Rule "Every turn when the number of entries in the current script is not 0" applies.]
[Rule "Rule for firing a scripted event ( called x )" applies.]
"And don't come out till that clock's shining!" shouts Drake from the hall.

"Yeah," Calvin says. "It's got to look as good as if we did it!"

"Idiot," Drake mutters. "Come on."

Their voices disappear down the hall.

[Rule "Last after firing something ( called the certain trigger )" applies.]

>trace
[Trace on.]

>rules all
[Parsing for the verb 'rules' (3 lines)]
[line 0 * -> RulesOn]
[line 1 * 'all' -> RulesAll]
[Line successfully parsed]
Rules tracing now switched to "all". Type "rules off" to switch it off again.

* * *

>unlock clock
(with my lucky clock key)
That doesn't seem to be something I can unlock.

"And don't come out till that clock's shining!" shouts Drake from the hall.

"Yeah," Calvin says. "It's got to look as good as if we did it!"

"Idiot," Drake mutters. "Come on."

Their voices disappear down the hall.

>showme
Abbot's Quarters - room
    Abbot's Door - open door
    myself - person
        my lucky clock key (worn)
        rag
        tumbler - open container
            small amount of polish
    Gubbler's Grandfather clock - closed door
        clock-door (part of Gubbler's Grandfather clock)
            keyhole (part of clock-door)
    Abbot's cot
    Abbot's desk
    bust of St. Newton
    barred window - window

* * *

>x polish
A small glass with all that's left of my daily wood polish ration. How I'm supposed to do all the rest of my chores after this I don't know, but Drake and Calvin didn't seem too worried about that.

"And don't come out till that clock's shining!" shouts Drake from the hall.

"Yeah," Calvin says. "It's got to look as good as if we did it!"

"Idiot," Drake mutters. "Come on."

Their voices disappear down the hall.

>use polish
You will have to be more specific about your intentions.

The grandfather clock ticks off a minute with a stately thunk. Quickly, I make the sign of the winding gear.

>polish
What do I want to polish?

* * *

>use clock
I should polish the outside of the clock first, and that'll probably take more than long enough.

"And don't come out till that clock's shining!" shouts Drake from the hall.

"Yeah," Calvin says. "It's got to look as good as if we did it!"

"Idiot," Drake mutters. "Come on."

Their voices disappear down the hall.

>use rag
You will have to be more specific about your intentions.

The grandfather clock ticks off a minute with a stately thunk. Quickly, I make the sign of the winding gear.

>use rag on clock
I can't see any such thing.

>enter clock
I should polish the outside of the clock first, and that'll probably take more than long enough.

From the hallway outside comes the echo of voices. Too shaky to be Calvin or Drake. More like - oh, no. It's the Abbot, coming back to his room. And if he finds me here, then my springs won't be worth the spindles they're sprung to…

* * *

>w
I'm going to have to tell someone what I just heard. A theft, from the Vaults! But if the Abbot's involved - then who else might be? After all, the figure he was talking to could have been anyone in the Abbey!

Corridor of Contemplation
The ancient stones of the Abbey rise to about shoulder-height before arching over, forcing me to bow my head in supplication before the Abbot's door, back east. To the west, I can hear the gentle echo of ticks and tocks coming from the Abbey's main hall.

Carved into the walls are a series of pious engravings, depicting the long path from initiate to Abbot.

>w
I dart of the tunnel, only to be stopped dead by a depressing sight. It's Calvin and Drake, hurrying in through the Abbey's Great Entry. Their mouths are white with sugar.

"Hey, you!" Drake shouts. In a moment he's got me by the ear. "What were you doing in the Abbot's room? That's not on your rota!"

"Yeah!" Calvin adds. "And why are you slipping away when we told you to be there?"

"Idiot," Drake hisses. Louder - for the benefit of any passing monks - he says, "That's it, Wren. You're consigned to your room." For good measure, he punches me on the arm, then the two of them drag me away, heels over flagstones, right to the bottom of the ladder.

"Up you go," Calvin says. "And you're not to come down till dark!"

"What about dinner?" I ask.

"Should have thought of that, shouldn't you?" Drake says.

"More for us," Calvin adds. "Only two hours to go. I'm starved."

With that, they punch me again, and wait until I scurry away up the ladder.

Attic Room
This isn't really an attic. It isn't really a room either. It's a couple of floorboards laid across some roof rafters right in the ceiling of the Abbey. There's enough floor-space for a cot and a laundry crate, but I have to be careful not to roll out of bed, because if I do, the thick cobwebs all around aren't going to stop me from falling….

A little hole in the ceiling provides some sunlight: and when it rains, it means I can wash my hair, too. It's right above the rickety ladder down to the ground (and that means the ladder is starting to rot and bend).

Through my window I can see the Cathedral across the yard outside. If I was a bird, I could escape easily, and tell someone what I've overheard. The Abbot's about to do something terrible and I've got to stop him! Someone at the Cathedral would listen: the Archbishop himself, perhaps. He might remember me from the time he visited, when he helped me repair an altimeter I'd broken. If only I could fly.

But perhaps I can escape on foot. If I'm clever. Clockwise.

* * *

>z
Time passes.

>w
Central Hall
I'm standing in the very centre of the Abbey's Great Hall. It's impossible not to crane my neck here, to gaze up at the ceiling held aloft by buttresses like gigantic oak trees. To think, people built this in the days before proper pulley-transmissions! It must have taken weeks! The hall continues northeast into shadow, and southwest, towards the sunlight, the Yard and above all, the Archbishop.

The vast empty space is filled by the muttering and echo of Holy Mechanisms, and the hiss of the candles as they sweep around their Tracks, providing a little light everywhere but rarely ever enough. I can just make out archways both east and west.

Distantly - but not distantly enough - I can hear the clock and clatter of Drake's boots. The sound's coming from the west.

>w
I catch the sound of hobnailed boots. Drake's heading this way! I'd better wait, and let him pass.

Looking west, I can see Drake. He's coming this way!

>undo
Central Hall
[Previous turn undone.]

>sw
Lower Hall
Looking northeast, the Great Hall of the Abbey stretches away like the belly of some big beast, its bony roof held up by pillars like swallowed trees. The walls are carelessly lit by candles moving through Sacred Tracks suspended in the air. I can just make out the Corridor of Contemplation to the east, and the wider archway to the Scriptorium to the west.

But more importantly, the great Entry - and exit - of the Abbey is to the southwest. And if I'm going to get out of here and talk to the Archbishop that's the only way to go.

But maybe you're starting to see what kind of luck I have. Right there, in the Entry, is Calvin, working on a clock.

* * *

>e
Central Hall
I'm standing in the very centre of the Abbey's Great Hall. It's impossible not to crane my neck here, to gaze up at the ceiling held aloft by buttresses like gigantic oak trees. To think, people built this in the days before proper pulley-transmissions! It must have taken weeks! The hall continues northeast into shadow, and southwest, towards the sunlight, the Yard and above all, the Archbishop.

The vast empty space is filled by the muttering and echo of Holy Mechanisms, and the hiss of the candles as they sweep around their Tracks, providing a little light everywhere but rarely ever enough. I can just make out archways both east and west.

>ne
Upper Hall
The Great Hall of the Abbey is the biggest room I've seen in my life, running from this end all the way southwest (and it is all the way, I'm never allowed further) to the Great Doors and the Yard outside. If I crane my neck I can see the dark square of the floorboards of my room - the ladder is on one side, to the west. Lights move in and out overhead, from the candles moving on their Holy Tracks. Strong smells float through an archway to the east.

From their niches, the Three Major Saints are watching sternly, keen that I should get out of the Cathedral and talk to the Archbishop as quickly as possible.

Looking east, I can see Drake. He's coming this way!

>w
Rickety Stair
I'm in one corner of the Great Hall, just by the foot of the ladder up to my room. There's a note attached to it, asking Amble the caretaker not to put it back in the shed just yet.

* * *

>put cup in machine
(the Tea Machine)
Done.

>put tea leaves in machine
(the tea leaves in the Tea Machine)
(first taking some tea from the jar)
The basket's now filled with tea leaves.

>turn spigot
The spigot releases a thin dribble of water into the kettle. Across the room, the clouds coming from the steamer suddenly thin out and the Cook pauses to give me the most evil of evil stares. I turn the spigot closed again.

Drake's clattering boots are audible to the south.

>wind key
(the tea machine key)
A few turns and the spring is fully wound.

Drake's just off to the south, and he's coming this way!

>pull lever
The lever locks down and sets the first few gears in motion. But it doesn't seem to be carrying over correctly. I can't help but notice a worn down gear in the middle of the train, no longer catching teeth with its fellows. I make the sign of Sad Depreciation.

I release the lever and it springs back up.

"Wren!" Drake exclaims. He wallops me on the arm. "I thought I told you to stay in your room?" He doesn't wait for an excuse before I'm dragged off to the ladder. Then he waits - and wallops me - until I give in and climb all the way back up.

Attic Room
This isn't really an attic. It isn't really a room either. It's a couple of floorboards laid across some roof rafters right in the ceiling of the Abbey. There's enough floor-space for a cot and a laundry crate, but I have to be careful not to roll out of bed, because if I do, the thick cobwebs all around aren't going to stop me from falling….

A little hole in the ceiling provides some sunlight: and when it rains, it means I can wash my hair, too. It's right above the rickety ladder down to the ground (and that means the ladder is starting to rot and bend).

That was careless, getting caught. But I can still make it to the Cathedral. I'll just have to be more cunning this time. Remember, Wren, it's easy: the whole world runs on clockwork. Just a matter of staying ahead of the biting teeth.

>undo
Kitchen
[Previous turn undone.]

>w
Upper Hall
The Great Hall of the Abbey is the biggest room I've seen in my life, running from this end all the way southwest (and it is all the way, I'm never allowed further) to the Great Doors and the Yard outside. If I crane my neck I can see the dark square of the floorboards of my room - the ladder is on one side, to the west. Lights move in and out overhead, from the candles moving on their Holy Tracks. Strong smells float through an archway to the east.

From their niches, the Three Major Saints are watching sternly, keen that I should get out of the Cathedral and talk to the Archbishop as quickly as possible.

Drake's just off to the east, and he's coming this way!

>sw
Central Hall
I'm standing in the very centre of the Abbey's Great Hall. It's impossible not to crane my neck here, to gaze up at the ceiling held aloft by buttresses like gigantic oak trees. To think, people built this in the days before proper pulley-transmissions! It must have taken weeks! The hall continues northeast into shadow, and southwest, towards the sunlight, the Yard and above all, the Archbishop.

The vast empty space is filled by the muttering and echo of Holy Mechanisms, and the hiss of the candles as they sweep around their Tracks, providing a little light everywhere but rarely ever enough. I can just make out archways both east and west.

Looking northeast, I can see Drake. He's coming this way!

>w
Library
The Abbey's library is small compared to the one in the Cathedral. There's nothing on the shelves but the key texts: the Principia, the Mechanistica and the Determininium. Only Brother Horloge, the Abbey's Primary Reader ever seems to use them - he's here at the moment, studying at his desk by the poor light coming through the stained glass windows. By his elbow is a fat bunch of keys. On his shoulder is his mechanical owl, wings folded.

An archway leads east back into the hall. From the southwest comes the clatter of Writing hammers and the sharp smell of burnt ink.

>get gear
I can't see any such thing.

>undo
Library
[Previous turn undone.]

>sw
Scriptorium
The Scriptorium is where the Copying takes place, though it's hard to believe that Copying once meant a team of monks working with carved rubber stamps. It's all done by mechanisms now, of course, like everything else except my chores. There's the massive Gutenberg press on the west wall, and everywhere else is Brother Reloh's Duplicator. Twenty-three Typewriters, all clattering away as though operated by ghosts, all connected by a single Carriage Arm that curves the length of the wall. To leave the room east or northeast I'll have to duck under.

Reloh works on one of the keyboards of the Duplicator, typing furiously. The hammering and punching is almost overwhelming.

The Gutenberg seems to be in the midst of a repair. The Cabinet of Relics next to it is open.

I've got a moment before Drake spots me: he's just appeared, to the east.

>undo
Library
[Previous turn undone.]

>undo
Central Hall
[Previous turn undone.]

>x
What do I want to examine?

>z
Time passes.

"Wren!" Drake exclaims. He wallops me on the arm. "I thought I told you to stay in your room?" He doesn't wait for an excuse before I'm dragged off to the ladder. Then he waits - and wallops me - until I give in and climb all the way back up.

Attic Room
This isn't really an attic. It isn't really a room either. It's a couple of floorboards laid across some roof rafters right in the ceiling of the Abbey. There's enough floor-space for a cot and a laundry crate, but I have to be careful not to roll out of bed, because if I do, the thick cobwebs all around aren't going to stop me from falling….

A little hole in the ceiling provides some sunlight: and when it rains, it means I can wash my hair, too. It's right above the rickety ladder down to the ground (and that means the ladder is starting to rot and bend).

That was careless, getting caught. But I can still make it to the Cathedral. I'll just have to be more cunning this time. Remember, Wren, it's easy: the whole world runs on clockwork. Just a matter of staying ahead of the biting teeth.

>undo
Central Hall
[Previous turn undone.]

>e
I see nothing unexpected in that direction.

"Wren!" Drake exclaims. He wallops me on the arm. "I thought I told you to stay in your room?" He doesn't wait for an excuse before I'm dragged off to the ladder. Then he waits - and wallops me - until I give in and climb all the way back up.

Attic Room
This isn't really an attic. It isn't really a room either. It's a couple of floorboards laid across some roof rafters right in the ceiling of the Abbey. There's enough floor-space for a cot and a laundry crate, but I have to be careful not to roll out of bed, because if I do, the thick cobwebs all around aren't going to stop me from falling….

A little hole in the ceiling provides some sunlight: and when it rains, it means I can wash my hair, too. It's right above the rickety ladder down to the ground (and that means the ladder is starting to rot and bend).

That was careless, getting caught. But I can still make it to the Cathedral. I'll just have to be more cunning this time. Remember, Wren, it's easy: the whole world runs on clockwork. Just a matter of staying ahead of the biting teeth.

>undo
Central Hall
[Previous turn undone.]

>go e
West Refectory
I spend some of my time here, eating at one of the two long tables. I spend even more serving the monks. Each of them has their own seat, marked by a little brass hourglass, and if the twenty or so I can see here weren't enough (which they aren't), there's more to the east, where the Refectory continues. Back west is the archway to the Great Hall.

>w
Just in time, I see Drake's there. I hang back, to let him move on.

* * *

>get gear
"Don't touch those," Reloh demands. So I don't touch.

>get new gear
"Don't touch those," Reloh demands. So I don't touch.

* * *

>wind key
(the tea machine key)
A few turns and the spring is fully wound.

Drake's just off to the south, and he's coming this way!

>w
Upper Hall
The Great Hall of the Abbey is the biggest room I've seen in my life, running from this end all the way southwest (and it is all the way, I'm never allowed further) to the Great Doors and the Yard outside. If I crane my neck I can see the dark square of the floorboards of my room - the ladder is on one side, to the west. Lights move in and out overhead, from the candles moving on their Holy Tracks. Strong smells float through an archway to the east.

From their niches, the Three Major Saints are watching sternly, keen that I should get out of the Cathedral and talk to the Archbishop as quickly as possible.

I've got a moment before Drake spots me: he's just appeared, to the east.

* * *

>e
Kitchen
If there was ever a proof of the perfection of Clockwork over Nature, it's that the dirtiest and most hectic room in the whole Abbey is its Kitchen. Shelves, walls and floor are covered by machines belching, slicing, steaming, chopping, stirring, boiling, broiling, frying, pureeing … the list goes on. The noise, smell and heat is almost overpowering, and the Cook, who controls this madhouse, can only stand it because he's stone deaf.

In one corner is the only machine I'm allowed to use: the Tea Maker. There's a jar of tea leaf beside it. In the bracket of the machine is a teacup. 

I can escape back into the cool of the Hall to the west. South, through a broad arch, is the Refectory.

The cook knocks past me, to unclip the crumb-sucker.

>get gear
Which do I mean, the gear train or the small gear?

* * *

>small
While the Cook is distracted - the Cook is always distracted - I pluck the out the worn down gear. Not the sort of repair a clock polisher should be doing!

>w
Upper Hall
The Great Hall of the Abbey is the biggest room I've seen in my life, running from this end all the way southwest (and it is all the way, I'm never allowed further) to the Great Doors and the Yard outside. If I crane my neck I can see the dark square of the floorboards of my room - the ladder is on one side, to the west. Lights move in and out overhead, from the candles moving on their Holy Tracks. Strong smells float through an archway to the east.

From their niches, the Three Major Saints are watching sternly, keen that I should get out of the Cathedral and talk to the Archbishop as quickly as possible.

* * *

>get gear
(the new gear)
"Put that back," Reloh snaps, without looking up. But I don't put it back.

Drake's footsteps echo in from the east.

>ne
Library
The Abbey's library is small compared to the one in the Cathedral. There's nothing on the shelves but the key texts: the Principia, the Mechanistica and the Determininium. Only Brother Horloge, the Abbey's Primary Reader ever seems to use them - he's here at the moment, studying at his desk by the poor light coming through the stained glass windows. By his elbow is a fat bunch of keys. On his shoulder is his mechanical owl, wings folded.

An archway leads east back into the hall. From the southwest comes the clatter of Writing hammers and the sharp smell of burnt ink.

Drake's on patrol, and I can hear him heading this way, from the southwest.

>e
Central Hall
I'm standing in the very centre of the Abbey's Great Hall. It's impossible not to crane my neck here, to gaze up at the ceiling held aloft by buttresses like gigantic oak trees. To think, people built this in the days before proper pulley-transmissions! It must have taken weeks! The hall continues northeast into shadow, and southwest, towards the sunlight, the Yard and above all, the Archbishop.

The vast empty space is filled by the muttering and echo of Holy Mechanisms, and the hiss of the candles as they sweep around their Tracks, providing a little light everywhere but rarely ever enough. I can just make out archways both east and west.

Drake's footsteps echo in from the west.

>ne
Upper Hall
The Great Hall of the Abbey is the biggest room I've seen in my life, running from this end all the way southwest (and it is all the way, I'm never allowed further) to the Great Doors and the Yard outside. If I crane my neck I can see the dark square of the floorboards of my room - the ladder is on one side, to the west. Lights move in and out overhead, from the candles moving on their Holy Tracks. Strong smells float through an archway to the east.

From their niches, the Three Major Saints are watching sternly, keen that I should get out of the Cathedral and talk to the Archbishop as quickly as possible.

>e
Kitchen
If there was ever a proof of the perfection of Clockwork over Nature, it's that the dirtiest and most hectic room in the whole Abbey is its Kitchen. Shelves, walls and floor are covered by machines belching, slicing, steaming, chopping, stirring, boiling, broiling, frying, pureeing … the list goes on. The noise, smell and heat is almost overpowering, and the Cook, who controls this madhouse, can only stand it because he's stone deaf.

In one corner is the only machine I'm allowed to use: the Tea Maker. There's a jar of tea leaf beside it. In the bracket of the machine is a teacup. 

I can escape back into the cool of the Hall to the west. South, through a broad arch, is the Refectory.

>put new gear in gear train
The gear train forms a perfect snake from the lever, over the semi-circular bracket and into the innards of the machine.

Drake's on patrol, and I can hear him heading this way, from the south.

>pull lever
The gear train whirrs into life, swinging the kettle across inside the machine. Its base knocks open the gas-pipe tap. A jet of gas hisses out, blowing up a tiny sail attached by thread to the flint-iron. The burner is quickly alight.

The cook bustles past me, to thump the oven.

I've got a moment before Drake spots me: he's just appeared, to the south.

>w
Upper Hall
The Great Hall of the Abbey is the biggest room I've seen in my life, running from this end all the way southwest (and it is all the way, I'm never allowed further) to the Great Doors and the Yard outside. If I crane my neck I can see the dark square of the floorboards of my room - the ladder is on one side, to the west. Lights move in and out overhead, from the candles moving on their Holy Tracks. Strong smells float through an archway to the east.

From their niches, the Three Major Saints are watching sternly, keen that I should get out of the Cathedral and talk to the Archbishop as quickly as possible.

Drake's just off to the east, and he's coming this way!

* * *

>get tea
(the cup of tea)
I lift the cup carefully from the machine. The Cook turns and for the first time seems to notice me. He looks furious. "And where you thin' you go wi' tha'?" he demands. "Wait. Wa'."

After a bit of tidying, he finds a button to press. A machine coughs and wheezes, and eventually a small half-slice of lemon squeezes from a slot. The Cook snatches it and drops it into my tea cup. "Ri' you are," he says, and then waves me away.

>w
Upper Hall
The Great Hall of the Abbey is the biggest room I've seen in my life, running from this end all the way southwest (and it is all the way, I'm never allowed further) to the Great Doors and the Yard outside. If I crane my neck I can see the dark square of the floorboards of my room - the ladder is on one side, to the west. Lights move in and out overhead, from the candles moving on their Holy Tracks. Strong smells float through an archway to the east.

From their niches, the Three Major Saints are watching sternly, keen that I should get out of the Cathedral and talk to the Archbishop as quickly as possible.

* * *

>w
Library
The Abbey's library is small compared to the one in the Cathedral. There's nothing on the shelves but the key texts: the Principia, the Mechanistica and the Determininium. Only Brother Horloge, the Abbey's Primary Reader ever seems to use them - he's here at the moment, studying at his desk by the poor light coming through the stained glass windows. By his elbow is a fat bunch of keys. On his shoulder is his mechanical owl, wings folded.

An archway leads east back into the hall. From the southwest comes the clatter of Writing hammers and the sharp smell of burnt ink.

>put tea on desk
I can't see any such thing.

>put tea on table
I set the cup down beside Brother Horloge's elbow. "Excellent, there," he says, beaming, nostrils twitching. "Such a smell! The finest!" He lifts the cup, takes a sip and smacks his lips. "It's the slight metallic tang that really gives it the whotsit," he adds. His eyes half-close in calm delight.

>ask horloge about tea
"You like your tea?" I ask.

"Young Whotsit, it's about as fine as it could be," he replies cheerfully.

He's so enthusiastic as he talks that he knocks his keys onto the floor, though he doesn't seem to notice.

>get keys
Very quietly, I pick the keys up off the ground. With his eyes half-shut, Horloge doesn't notice.

Drake's clattering boots are audible to the southwest.

>e
Central Hall
I'm standing in the very centre of the Abbey's Great Hall. It's impossible not to crane my neck here, to gaze up at the ceiling held aloft by buttresses like gigantic oak trees. To think, people built this in the days before proper pulley-transmissions! It must have taken weeks! The hall continues northeast into shadow, and southwest, towards the sunlight, the Yard and above all, the Archbishop.

The vast empty space is filled by the muttering and echo of Holy Mechanisms, and the hiss of the candles as they sweep around their Tracks, providing a little light everywhere but rarely ever enough. I can just make out archways both east and west.

Drake's footsteps echo in from the west.

>e
West Refectory
I spend some of my time here, eating at one of the two long tables. I spend even more serving the monks. Each of them has their own seat, marked by a little brass hourglass, and if the twenty or so I can see here weren't enough (which they aren't), there's more to the east, where the Refectory continues. Back west is the archway to the Great Hall.

Drake's clattering boots are audible to the west.

>e
East Refectory
The eastern end of the long Refectory is given over in part to the tables lined with brass hourglasses, but in the other half there's nothing but the enormous Refectory Clock. It's an impressive thing, so big because it only needs winding once a year, despite all the gongs, cymbals, tubes and bells that strike when dinner time comes around. Right now, the clock is showing the time at just after ten past four.

Pungent smells drift in from the kitchen to the north. On the east wall is the small green door to the Abbey's herb garden.

Drake's on patrol, and I can hear him heading this way, from the west.

>unlock clock
(with Horloge's Keys)
I unlock the Refectory Clock.

I've got a moment before Drake spots me: he's just appeared, to the west.

>turn clock to 5
Putting a clock wrong turns my stomach… but the thought of that Figure in Grey spurs me on. So I make the sign of the Winding Key - maybe that'll buy me some forgiveness when I wind down. Then I push the hands round to five o'clock.

The clash of metal on metal: the Refectory Clock leaps into life like an advancing army, its bells, gongs and organ pipes ringing and chiming and clanging away! Very, very quickly, I slam shut the clock case door and, covering my ears, rush over to the other side of the room. It's still horribly loud.

>w
West Refectory
I spend some of my time here, eating at one of the two long tables. I spend even more serving the monks. Each of them has their own seat, marked by a little brass hourglass, and if the twenty or so I can see here weren't enough (which they aren't), there's more to the east, where the Refectory continues. Back west is the archway to the Great Hall.

Gongs, bells and all manner of noises are echoing around the walls.

Calvin and Drake explode into the room and barge me out of the way as they race over to the East Refectory.

>e
No way. The coast is clear to get out of the Abbey and over to the Cathedral, but only so long as Calvin and Drake are distracted in there.

Calvin and Drake race over to the clock and start struggling with the case. Both are hampered by keeping their hands over both their ears at the same time.

>undo
West Refectory
[Previous turn undone.]

>ne
I can't go that way.

Calvin and Drake race over to the clock and start struggling with the case. Both are hampered by keeping their hands over both their ears at the same time.

>n
I can't go that way.

>undo
West Refectory
[Previous turn undone.]

>undo
West Refectory
[Previous turn undone.]

* * *

>undo
East Refectory
[Previous turn undone.]

>n
Kitchen
If there was ever a proof of the perfection of Clockwork over Nature, it's that the dirtiest and most hectic room in the whole Abbey is its Kitchen. Shelves, walls and floor are covered by machines belching, slicing, steaming, chopping, stirring, boiling, broiling, frying, pureeing … the list goes on. The noise, smell and heat is almost overpowering, and the Cook, who controls this madhouse, can only stand it because he's stone deaf.

I can escape back into the cool of the Hall to the west. South, through a broad arch, is the Refectory, where the Refectory Clock is throwing up a wall of sound.

>l
Kitchen
If there was ever a proof of the perfection of Clockwork over Nature, it's that the dirtiest and most hectic room in the whole Abbey is its Kitchen. Shelves, walls and floor are covered by machines belching, slicing, steaming, chopping, stirring, boiling, broiling, frying, pureeing … the list goes on. The noise, smell and heat is almost overpowering, and the Cook, who controls this madhouse, can only stand it because he's stone deaf.

I can escape back into the cool of the Hall to the west. South, through a broad arch, is the Refectory, where the Refectory Clock is throwing up a wall of sound.

The ringing of the Refectory Clock makes the very walls shake.

Calvin and Drake race over to the clock and start struggling with the case. Both are hampered by keeping their hands over both their ears at the same time.

The cook knocks past me, to respring the steamer.

>w
Upper Hall
The Great Hall of the Abbey is the biggest room I've seen in my life, running from this end all the way southwest (and it is all the way, I'm never allowed further) to the Great Doors and the Yard outside. If I crane my neck I can see the dark square of the floorboards of my room - the ladder is on one side, to the west. Lights move in and out overhead, from the candles moving on their Holy Tracks. Strong smells float through an archway to the east.

From their niches, the Three Major Saints are watching sternly, keen that I should get out of the Cathedral and talk to the Archbishop as quickly as possible.

* * *

>e
West Refectory
I spend some of my time here, eating at one of the two long tables. I spend even more serving the monks. Each of them has their own seat, marked by a little brass hourglass, and if the twenty or so I can see here weren't enough (which they aren't), there's more to the east, where the Refectory continues. Back west is the archway to the Great Hall.

>e
No way. The coast is clear to get out of the Abbey and over to the Cathedral, but only so long as Calvin and Drake are distracted in there.

>w
Central Hall
I'm standing in the very centre of the Abbey's Great Hall. It's impossible not to crane my neck here, to gaze up at the ceiling held aloft by buttresses like gigantic oak trees. To think, people built this in the days before proper pulley-transmissions! It must have taken weeks! The hall continues northeast into shadow, and southwest, towards the sunlight, the Yard and above all, the Archbishop.

The vast empty space is filled by the muttering and echo of Holy Mechanisms, and the hiss of the candles as they sweep around their Tracks, providing a little light everywhere but rarely ever enough. I can just make out archways both east and west.

The Abbey has turned into a giant trumpet, echoing the sound of bells.

>w
Library
The Abbey's library is small compared to the one in the Cathedral. There's nothing on the shelves but the key texts: the Principia, the Mechanistica and the Determininium. Only Brother Horloge, the Abbey's Primary Reader ever seems to use them - he's here at the moment, studying at his desk by the poor light coming through the stained glass windows. On his shoulder is his mechanical owl, wings folded.

An archway leads east back into the hall. From the southwest comes the clatter of Writing hammers and the sharp smell of burnt ink.

The stonework resounds with the sounds of gongs.

>sw
Scriptorium
The Scriptorium is where the Copying takes place, though it's hard to believe that Copying once meant a team of monks working with carved rubber stamps. It's all done by mechanisms now, of course, like everything else except my chores. There's the massive Gutenberg press on the west wall, and everywhere else is Brother Reloh's Duplicator. Twenty-three Typewriters, all clattering away as though operated by ghosts, all connected by a single Carriage Arm that curves the length of the wall. To leave the room east or northeast I'll have to duck under.

Reloh works on one of the keyboards of the Duplicator, typing furiously. The hammering and punching is almost overwhelming.

The Gutenberg seems to be in the midst of a repair. The Cabinet of Relics next to it is open.

The ringing of the Refectory Clock makes the very walls shake.

>x reloh
Brother Reloh is unusually young. He's also unusually pious, firm and committed to work. The only time I've ever seen him smile was when Brother Horloge sat on his spectacles right before he was supposed to read Grace. Reloh works here in the Scriptorium night and day, replicating the Proper Texts "for the edification of…", well, pretty much everyone.

>ask reloh about press
"Close your mouth," Reloh snipes. So I close my mouth.

>x press
(the Gutenberg Press)
A massive Gutenberg press, the source of all the city of St Philip's holy texts and condemnations. The recent spate of pamphlets advising against "heretical new ideas" - whatever they might be - has run the press down rather severely. I make the sign of Sad Depreciation. Reloh sees, and nods his approval.

The Gutenberg Press is currently switched off.

>n
I can't go that way.

The ringing of the Refectory Clock makes the very walls shake.

>ne
Library
The Abbey's library is small compared to the one in the Cathedral. There's nothing on the shelves but the key texts: the Principia, the Mechanistica and the Determininium. Only Brother Horloge, the Abbey's Primary Reader ever seems to use them - he's here at the moment, studying at his desk by the poor light coming through the stained glass windows. On his shoulder is his mechanical owl, wings folded.

An archway leads east back into the hall. From the southwest comes the clatter of Writing hammers and the sharp smell of burnt ink.

>ask horloge about foo
I've already asked about that.

There is no reply.

>ask horloge about blah
I've already asked about that.

There is no reply.

>sw
Scriptorium
The Scriptorium is where the Copying takes place, though it's hard to believe that Copying once meant a team of monks working with carved rubber stamps. It's all done by mechanisms now, of course, like everything else except my chores. There's the massive Gutenberg press on the west wall, and everywhere else is Brother Reloh's Duplicator. Twenty-three Typewriters, all clattering away as though operated by ghosts, all connected by a single Carriage Arm that curves the length of the wall. To leave the room east or northeast I'll have to duck under.

Reloh works on one of the keyboards of the Duplicator, typing furiously. The hammering and punching is almost overwhelming.

The Gutenberg seems to be in the midst of a repair. The Cabinet of Relics next to it is open.

>ask horloge about blah
I can't see any such thing.

* * *

>ask reloh about press
"Close your mouth," Reloh snipes. So I close my mouth.

>ne
Library
The Abbey's library is small compared to the one in the Cathedral. There's nothing on the shelves but the key texts: the Principia, the Mechanistica and the Determininium. Only Brother Horloge, the Abbey's Primary Reader ever seems to use them - he's here at the moment, studying at his desk by the poor light coming through the stained glass windows. On his shoulder is his mechanical owl, wings folded.

An archway leads east back into the hall. From the southwest comes the clatter of Writing hammers and the sharp smell of burnt ink.

Horloge is clearly enjoying his cup of tea.

>ask horloge about owl
"I like your owl," I tell him. "It's artificial?"

"Of course it is," he says. "Her name's Rachael."

>ask horloge about rachael
I've already asked about that.

>ask horloge about tea
I've already asked about that.

The stonework resounds with the sounds of gongs.

Brother Horloge leans back in his chair and sips his tea with eyes closed.

>ask horloge about himself
"How are you, Brother Horloge?" I ask.

"Perfectly well. Can't complain." He looks very content, in fact, holding his cup and petting his owl. "Abbey life is very fine."

Horloge reaches up to stroke his owl. The bird is motionless.

>ask horloge about abbot
"What do you think about the Abbot?" I begin. Maybe I can tell Horloge what I overheard.

"The Abbot," he replies distantly. "I don't think I've seen old Whotsit in a while. Not seen much, actually. Funny thing." He takes off his spectacles and wipes them on his sleeve.

No good, clearly. I'm going to have to tell the Archbishop; no-one round here is going to lift a finger.

>x glasses
I can't see any such thing.

>x horlohe
I can't see any such thing.

>x horloge
Horloge's eyes are screwed up behind the most complicated pair of spectacles I've ever encountered. They make it hard to even see his eyes - or rather what's left of them. He's read in the darkness here in the Library for so long he's basically blind. On his shoulder sits his pet owl. Same as Brother Horloge it looks more fearsome than it actually is.

He's sipping his tea, quite content, eyes half-closed.

>x owl
Horloge's mechanical owl sits on his shoulder. It seems to be asleep, its spring unwound.

>wind owl
Nothing obvious happens.

>ask horloge about gongs
"Isn't that the gong for dinner?" I ask.

"No, can't be," Horloge replies calmly. "See where the sun is? If it was 5 o'clock now, I'd have pushed the table right over against that wall."

The ringing of the Refectory Clock makes the very walls shake.

>ask horloge about gong
I've already asked about that.

>e
Central Hall
I'm standing in the very centre of the Abbey's Great Hall. It's impossible not to crane my neck here, to gaze up at the ceiling held aloft by buttresses like gigantic oak trees. To think, people built this in the days before proper pulley-transmissions! It must have taken weeks! The hall continues northeast into shadow, and southwest, towards the sunlight, the Yard and above all, the Archbishop.

The vast empty space is filled by the muttering and echo of Holy Mechanisms, and the hiss of the candles as they sweep around their Tracks, providing a little light everywhere but rarely ever enough. I can just make out archways both east and west.

>sw
Lower Hall
Looking northeast, the Great Hall of the Abbey stretches away like the belly of some big beast, its bony roof held up by pillars like swallowed trees. The walls are carelessly lit by candles moving through Sacred Tracks suspended in the air. I can just make out the Corridor of Contemplation to the east, and the wider archway to the Scriptorium to the west.

But more importantly, the great Entry - and exit - of the Abbey is to the southwest. And if I'm going to get out of here and talk to the Archbishop that's the only way to go.

But maybe you're starting to see what kind of luck I have. Right there, in the Entry, is Calvin, working on a clock.

I can see Calvin here.

* * *

>sw
Central Hall
I'm standing in the very centre of the Abbey's Great Hall. It's impossible not to crane my neck here, to gaze up at the ceiling held aloft by buttresses like gigantic oak trees. To think, people built this in the days before proper pulley-transmissions! It must have taken weeks! The hall continues northeast into shadow, and southwest, towards the sunlight, the Yard and above all, the Archbishop.

The vast empty space is filled by the muttering and echo of Holy Mechanisms, and the hiss of the candles as they sweep around their Tracks, providing a little light everywhere but rarely ever enough. I can just make out archways both east and west.

Drake's on patrol, and I can hear him heading this way, from the west.

>e
West Refectory
I spend some of my time here, eating at one of the two long tables. I spend even more serving the monks. Each of them has their own seat, marked by a little brass hourglass, and if the twenty or so I can see here weren't enough (which they aren't), there's more to the east, where the Refectory continues. Back west is the archway to the Great Hall.

Drake's footsteps echo in from the west.

>undo
Central Hall
[Previous turn undone.]

* * *

>e
Corridor of Contemplation
The ancient stones of the Abbey rise to about shoulder-height before arching over, forcing me to bow my head in supplication before the Abbot's door, back east. To the west, I can hear the gentle echo of ticks and tocks coming from the Abbey's main hall.

Carved into the walls are a series of pious engravings, depicting the long path from initiate to Abbot.

>e
Abbot's Quarters
If I thought Abbots lived in luxury, then I was dead wrong. Even my attic's cosier than this. The Abbot's got no furniture at all, except a desk and a cot, and no decoration except for a bust of St. Newton. None of the axle-mounted bevelled mobiles I was expecting. There's barely even any sunlight: one thin window to catch the sun-rise, opposite the door to the hallway back west.

St. Newton is staring at the Abbot's unpolished Grandfather clock with a severe frown.

I can also see Abbot Gubbler here.

>undo
Corridor of Contemplation
[Previous turn undone.]

>close door
I close the Abbot's Door.

>e
I knock before entering the Abbot's study.

I"ll have to get out of the Abbot's Quarters first.

>undo
Corridor of Contemplation
[Previous turn undone.]

>open door
I knock before entering the Abbot's study.

Abbot's Quarters
If I thought Abbots lived in luxury, then I was dead wrong. Even my attic's cosier than this. The Abbot's got no furniture at all, except a desk and a cot, and no decoration except for a bust of St. Newton. None of the axle-mounted bevelled mobiles I was expecting. There's barely even any sunlight: one thin window to catch the sun-rise, opposite the door to the hallway back west.

St. Newton is staring at the Abbot's unpolished Grandfather clock with a severe frown.

I can also see Abbot Gubbler here.

>undo
Corridor of Contemplation
[Previous turn undone.]

>close door
That's already closed.

>use door
I knock before entering the Abbot's study.

I"ll have to get out of the Abbot's Quarters first.

>undo
Corridor of Contemplation
[Previous turn undone.]

>actions
Actions listing on.

>use door
[entering the Abbot's Door]
[(1) going the Abbot's Door]
[(2) opening the Abbot's Door - silently]
I knock before entering the Abbot's study.

[(3) entering the Abbot's Door - silently]
[(4) going the Abbot's Door - silently]
[(4) going the Abbot's Door - silently - succeeded]
[(3) entering the Abbot's Door - silently - succeeded]
[(2) opening the Abbot's Door - silently - succeeded]
I"ll have to get out of the Abbot's Quarters first.
[(1) going the Abbot's Door - failed the can't travel in what's not a vehicle rule]

[entering the Abbot's Door - failed the convert enter door into go rule]
[Drake going north]
[Drake going north - succeeded]

>l
[looking]
Abbot's Quarters
If I thought Abbots lived in luxury, then I was dead wrong. Even my attic's cosier than this. The Abbot's got no furniture at all, except a desk and a cot, and no decoration except for a bust of St. Newton. None of the axle-mounted bevelled mobiles I was expecting. There's barely even any sunlight: one thin window to catch the sun-rise, opposite the door to the hallway back west.

St. Newton is staring at the Abbot's unpolished Grandfather clock with a severe frown.

I can also see Abbot Gubbler here.

[looking - succeeded]
[Drake going west]
[Drake going west - succeeded]

>w
[going west]

Corridor of Contemplation
The ancient stones of the Abbey rise to about shoulder-height before arching over, forcing me to bow my head in supplication before the Abbot's door, back east. To the west, I can hear the gentle echo of ticks and tocks coming from the Abbey's main hall.

Carved into the walls are a series of pious engravings, depicting the long path from initiate to Abbot.

[going west - succeeded]
[Drake going southwest]
[Drake going southwest - succeeded]

>e
[going east]

Abbot's Quarters
If I thought Abbots lived in luxury, then I was dead wrong. Even my attic's cosier than this. The Abbot's got no furniture at all, except a desk and a cot, and no decoration except for a bust of St. Newton. None of the axle-mounted bevelled mobiles I was expecting. There's barely even any sunlight: one thin window to catch the sun-rise, opposite the door to the hallway back west.

St. Newton is staring at the Abbot's unpolished Grandfather clock with a severe frown.

I can also see Abbot Gubbler here.

[going east - succeeded]
[Drake going southwest]
[Drake going southwest - succeeded]

>w
[going west]

Corridor of Contemplation
The ancient stones of the Abbey rise to about shoulder-height before arching over, forcing me to bow my head in supplication before the Abbot's door, back east. To the west, I can hear the gentle echo of ticks and tocks coming from the Abbey's main hall.

Carved into the walls are a series of pious engravings, depicting the long path from initiate to Abbot.

[going west - succeeded]
[Drake going west]
[Drake going west - succeeded]

>use door
[entering the Abbot's Door]
[(1) going the Abbot's Door]

Abbot's Quarters
If I thought Abbots lived in luxury, then I was dead wrong. Even my attic's cosier than this. The Abbot's got no furniture at all, except a desk and a cot, and no decoration except for a bust of St. Newton. None of the axle-mounted bevelled mobiles I was expecting. There's barely even any sunlight: one thin window to catch the sun-rise, opposite the door to the hallway back west.

St. Newton is staring at the Abbot's unpolished Grandfather clock with a severe frown.

I can also see Abbot Gubbler here.

[(1) going the Abbot's Door - succeeded]
[entering the Abbot's Door - succeeded]
[Drake going northeast]
[Drake going northeast - succeeded]

>w
[going west]

Corridor of Contemplation
The ancient stones of the Abbey rise to about shoulder-height before arching over, forcing me to bow my head in supplication before the Abbot's door, back east. To the west, I can hear the gentle echo of ticks and tocks coming from the Abbey's main hall.

Carved into the walls are a series of pious engravings, depicting the long path from initiate to Abbot.

[going west - succeeded]
[Drake going east]
[Drake going east - succeeded]

>close door
[closing the Abbot's Door]
I close the Abbot's Door.

[closing the Abbot's Door - succeeded]
[Drake going east]
[Drake going east - succeeded]

>open door
[opening the Abbot's Door]
I knock before entering the Abbot's study.

[(1) entering the Abbot's Door]
[(2) going the Abbot's Door]
Abbot's Quarters
If I thought Abbots lived in luxury, then I was dead wrong. Even my attic's cosier than this. The Abbot's got no furniture at all, except a desk and a cot, and no decoration except for a bust of St. Newton. None of the axle-mounted bevelled mobiles I was expecting. There's barely even any sunlight: one thin window to catch the sun-rise, opposite the door to the hallway back west.

St. Newton is staring at the Abbot's unpolished Grandfather clock with a severe frown.

I can also see Abbot Gubbler here.

[(2) going the Abbot's Door - succeeded]
[(1) entering the Abbot's Door - succeeded]
[opening the Abbot's Door - succeeded]
[Drake going east]
[Drake going east - succeeded]

>w
[going west]

Corridor of Contemplation
The ancient stones of the Abbey rise to about shoulder-height before arching over, forcing me to bow my head in supplication before the Abbot's door, back east. To the west, I can hear the gentle echo of ticks and tocks coming from the Abbey's main hall.

Carved into the walls are a series of pious engravings, depicting the long path from initiate to Abbot.

[going west - succeeded]
[Drake going north]
[Drake going north - succeeded]

>close door
[closing the Abbot's Door]
I close the Abbot's Door.

[closing the Abbot's Door - succeeded]
[Drake going west]
[Drake going west - succeeded]

>e
[going east]
[(1) opening the Abbot's Door - silently]
I knock before entering the Abbot's study.

[(2) entering the Abbot's Door - silently]
[(3) going the Abbot's Door - silently]
[(3) going the Abbot's Door - silently - succeeded]
[(2) entering the Abbot's Door - silently - succeeded]
[(1) opening the Abbot's Door - silently - succeeded]
I"ll have to get out of the Abbot's Quarters first.
[going east - failed the can't travel in what's not a vehicle rule]

[Drake going southwest]
[Drake going southwest - succeeded]

* * *

>open door
(the Abbot's Door)
That's already open.

"And don't come out till that clock's shining!" shouts Drake from the hall.

"Yeah," Calvin says. "It's got to look as good as if we did it!"

"Idiot," Drake mutters. "Come on."

Their voices disappear down the hall.

>close door
(the Abbot's Door)
I close the Abbot's Door.

The grandfather clock ticks off a minute with a stately thunk. Quickly, I make the sign of the winding gear.

>open door
(the Abbot's Door)
I open the Abbot's Door.

From the hallway outside comes the echo of voices. Too shaky to be Calvin or Drake. More like - oh, no. It's the Abbot, coming back to his room. And if he finds me here, then my springs won't be worth the spindles they're sprung to…

>w
The Abbot's voice is getting nearer… If he sees I've been in here, he'll have me turning the paddles in the laundry room for a month! There's nothing for it, I'll have to escape.

The Abbot's voice is getting closer. The old man may move slower than a short hand, but he's definitely coming this way.

>enter clock
"We'll talk in here," I hear the Abbot saying, from right outside the door. "More private. More quiet. Much better." The old man steps inside the room, followed by a tall figure in grey. In the last tick before his old eyes can see me, I dive inside the gigantic clock case and pull closed the door.

Inside Clock Case
As the phrase goes, I'm stuck between a rack and a gear-trace; except here I'm in the narrow gap between the clock case door and the heavy swinging penduluum behind. And if that hit me, and disrupted the holy timings… well, there's no way they wouldn't notice when the clock-hands stopped moving, let's just say.

A little light shines in through the keyhole, which is almost covered by the Abbot's spare robe.

Oh, no… That click outside was the sound of the Abbot closing the door. Looks like he - and the grey figure I glimpsed with him - are going to be here for a while…

* * *

>sw
Central Hall
I'm standing in the very centre of the Abbey's Great Hall. It's impossible not to crane my neck here, to gaze up at the ceiling held aloft by buttresses like gigantic oak trees. To think, people built this in the days before proper pulley-transmissions! It must have taken weeks! The hall continues northeast into shadow, and southwest, towards the sunlight, the Yard and above all, the Archbishop.

The vast empty space is filled by the muttering and echo of Holy Mechanisms, and the hiss of the candles as they sweep around their Tracks, providing a little light everywhere but rarely ever enough. I can just make out archways both east and west.

Drake's just off to the west, and he's coming this way!

>sw
Lower Hall
Looking northeast, the Great Hall of the Abbey stretches away like the belly of some big beast, its bony roof held up by pillars like swallowed trees. The walls are carelessly lit by candles moving through Sacred Tracks suspended in the air. I can just make out the Corridor of Contemplation to the east, and the wider archway to the Scriptorium to the west.

But more importantly, the great Entry - and exit - of the Abbey is to the southwest. And if I'm going to get out of here and talk to the Archbishop that's the only way to go.

But maybe you're starting to see what kind of luck I have. Right there, in the Entry, is Calvin, working on a clock.

* * *

>e
Abbot's Quarters
If I thought Abbots lived in luxury, then I was dead wrong. Even my attic's cosier than this. The Abbot's got no furniture at all, except a desk and a cot, and no decoration except for a bust of St. Newton. None of the axle-mounted bevelled mobiles I was expecting. There's barely even any sunlight: one thin window to catch the sun-rise, opposite the door to the hallway back west.

St. Newton is staring at the Abbot's unpolished Grandfather clock with a severe frown.

I can also see Abbot Gubbler here.

>w
Corridor of Contemplation
The ancient stones of the Abbey rise to about shoulder-height before arching over, forcing me to bow my head in supplication before the Abbot's door, back east. To the west, I can hear the gentle echo of ticks and tocks coming from the Abbey's main hall.

Carved into the walls are a series of pious engravings, depicting the long path from initiate to Abbot.

>close door
I close the Abbot's Door.

>e
Abbot's Quarters
If I thought Abbots lived in luxury, then I was dead wrong. Even my attic's cosier than this. The Abbot's got no furniture at all, except a desk and a cot, and no decoration except for a bust of St. Newton. None of the axle-mounted bevelled mobiles I was expecting. There's barely even any sunlight: one thin window to catch the sun-rise, opposite the door to the hallway back west.

St. Newton is staring at the Abbot's unpolished Grandfather clock with a severe frown.

I can also see Abbot Gubbler here.

* * *

>close door
I close the Abbot's Door.

>open door
I open the Abbot's Door.

>close door
I close the Abbot's Door.

* * *

>actions
Actions listing on.

>e
[going east]
[(1) opening the Abbot's Door - silently]
[(1) opening the Abbot's Door - silently - succeeded]

Abbot's Quarters
If I thought Abbots lived in luxury, then I was dead wrong. Even my attic's cosier than this. The Abbot's got no furniture at all, except a desk and a cot, and no decoration except for a bust of St. Newton. None of the axle-mounted bevelled mobiles I was expecting. There's barely even any sunlight: one thin window to catch the sun-rise, opposite the door to the hallway back west.

St. Newton is staring at the Abbot's unpolished Grandfather clock with a severe frown.

I can also see Abbot Gubbler here.

[going east - succeeded]
[Drake going north]
[Drake going north - succeeded]

* * *

>polish door
(the Abbot's Door)
That seems clean enough as it is.

"And don't come out till that clock's shining!" shouts Drake from the hall.

"Yeah," Calvin says. "It's got to look as good as if we did it!"

"Idiot," Drake mutters. "Come on."

Their voices disappear down the hall.

>w
Curses to counterweights! It's not on my rota, this clock, so why should I finish off my polish on it? I head for the doorway - then freeze. Voices, coming down the hall. It's the Abbot himself, coming this way!

>open clock
I open the clock door and peek inside. For a big clock it's got a pretty small penduluum, about the size of Calvin's fist and not as big as Drake's. There's even enough space in front of it for the Abbot to hang up one of his spare robes.

The Abbot's voice is getting closer. The old man may move slower than a short hand, but he's definitely coming this way.

* * *

>x clock
No wonder Calvin and Drake didn't want to do this. Abbot Gubbler's Grandfather clock is enormous: the face is the size of a dinnerplate and the cabinet below is big enough to be a wardrobe. Even just polishing the doors will take half an hour. The whole thing might take all day.

"I told you now didn't I tell you?" old Abbot Gubbler is saying, plaintively. "Here? Why here? You shouldn't have come here."

The Figure says something in reply. I can only hear two words, but they're enough to stop my heart. "Failure," and "Consequences."

>look through keyhole
I can make out the Abbot's hands, which are shaking badly. But I can see nothing of the Figure.

"But these things, these things are not always tick-tock, they never are," the old man replies. His voice is quivering, quite different from the steady drone he has when intoning in Chapel. "The - item you asked about - it's in the Vaults, you see? The Vaults. Even if I could get in, I …"

The Figure is too far from the keyhole and speaks too quietly for me to hear clearly. "Disappointing," he says; and then "unslip your gears."

>listen with tumbler
Oh… well, then. I tip out the last of the polish onto the floor of the clock. At least that part will shine.

I put the glass tumbler carefully against the door, then lean down to press my ear against it. Fantastic! I can hear much more clearly now!

The Abbot is spluttering and choking. You've seen him like this only once, when as a young initiate you dropped and smashed an altimeter right before the Archbishop was due to visit.

The Figure continues. "Clearly you're too old to steal the item for us. We have a better mechanism for obtaining it. But you must provide us with the opportunity. Is that understood?"

The Abbot nods violently, shaking out agreement the way I might beat dirt from a duster. "My money?" he asks.

>z
Time passes.

There's the clink, of a pouch of golden minutes. A heavy pouch. The Figure, paying the Abbot…? Then suddenly, there's a third voice. "Sorry, Father, to interrupt, but you said…"

It's a monk of the Abbey. "Get out!" the Abbot screeches. His bearing's lost its oil, it seems. "Get out, get out!"

"But Father," the monk continues, "it's time, you know. You told me to tell you when it was time."

"Oh! Of course of course," he mumbles. "I'll… We'll continue this discussion later, then," he says, to the Figure.

"We certainly will," the Figure replies.

The Abbot leaves, and that leaves me alone, inside this clock, with the stranger outside. He's coming nearer… I can hear his fingers on the door of the case! I must have nudged the penduluum, he must have seen the clock-hands quiver… but then, there's the swish of his cloak as he moves away, and the click as the door closes. Phew.

* * *

>close door
I close the Abbot's Door.

>e
No fear. I'm not going back in there.

* * *

>close door
I close the Abbot's Door.

>w
I dart of the tunnel, only to be stopped dead by a depressing sight. It's Calvin and Drake, hurrying in through the Abbey's Great Entry. Their mouths are white with sugar.

"Hey, you!" Drake shouts. In a moment he's got me by the ear. "What were you doing in the Abbot's room? That's not on your rota!"

"Yeah!" Calvin adds. "And why are you slipping away when we told you to be there?"

"Idiot," Drake hisses. Louder - for the benefit of any passing monks - he says, "That's it, Wren. You're consigned to your room." For good measure, he punches me on the arm, then the two of them drag me away, heels over flagstones, right to the bottom of the ladder.

"Up you go," Calvin says. "And you're not to come down till dark!"

"What about dinner?" I ask.

"Should have thought of that, shouldn't you?" Drake says.

"More for us," Calvin adds. "Only two hours to go. I'm starved."

With that, they punch me again, and wait until I scurry away up the ladder.

Attic Room
This isn't really an attic. It isn't really a room either. It's a couple of floorboards laid across some roof rafters right in the ceiling of the Abbey. There's enough floor-space for a cot and a laundry crate, but I have to be careful not to roll out of bed, because if I do, the thick cobwebs all around aren't going to stop me from falling….

A little hole in the ceiling provides some sunlight: and when it rains, it means I can wash my hair, too. It's right above the rickety ladder down to the ground (and that means the ladder is starting to rot and bend).

Through my window I can see the Cathedral across the yard outside. If I was a bird, I could escape easily, and tell someone what I've overheard. The Abbot's about to do something terrible and I've got to stop him! Someone at the Cathedral would listen: the Archbishop himself, perhaps. He might remember me from the time he visited, when he helped me repair an altimeter I'd broken. If only I could fly.

But perhaps I can escape on foot. If I'm clever. Clockwise.

* * *

>e
Corridor of Contemplation
The ancient stones of the Abbey rise to about shoulder-height before arching over, forcing me to bow my head in supplication before the Abbot's door, back east. To the west, I can hear the gentle echo of ticks and tocks coming from the Abbey's main hall.

Carved into the walls are a series of pious engravings, depicting the long path from initiate to Abbot.

>e
I knock before entering the Abbot's study.

Abbot's Quarters
The Abbot's Quarters again. Gubbler is here, standing by his desk (no chair, remember?). He's looking right at me, waiting for me to explain why I'm interrupting him, and why I haven't run away back west yet.

Gubbler coughs into a fist. "Well, yes?" he demands.

>undo
Corridor of Contemplation
[Previous turn undone.]

>rules
Rules tracing now switched on. Type "rules off" to switch it off again, or "rules all" to include even rules which do not apply.

>e
[Rule "standard set going variables rule" applies.]
    [Rule "Before going through a closed door ( called the obstacle )" applies.]
    [Rule "Rule for implicitly opening the Abbot's Door when Introduction has ended" applies.]
    [Rule "can't open unless openable rule" applies.]
    [Rule "can't open what's locked rule" applies.]
    [Rule "can't open what's already open rule" applies.]
    [Rule "standard opening rule" applies.]
    [Rule "After opening the Abbot's Door when Introduction has ended and the location is the Corridor of Contemplation" applies.]
     [Rule "convert enter door into go rule" applies.]
     [Rule "standard set going variables rule" applies.]
     [Rule "can't travel in what's not a vehicle rule" applies.]
     [Rule "can't go through undescribed doors rule" applies.]
     [Rule "can't go through closed doors rule" applies.]
     [Rule "determine map connection rule" applies.]
     [Rule "can't go that way rule" applies.]
     [Rule "move player and vehicle rule" applies.]
     [Rule "move floating objects rule" applies.]
     [Rule "check light in new location rule" applies.]
    [Rule "can't travel in what's not a vehicle rule" applies.]
I"ll have to get out of the Abbot's Quarters first.

[Rule "Every turn during Drake's Patrol" applies.]
[Rule "standard set going variables rule" applies.]
    [Rule "can't travel in what's not a vehicle rule" applies.]
    [Rule "can't go through undescribed doors rule" applies.]
    [Rule "can't go through closed doors rule" applies.]
    [Rule "determine map connection rule" applies.]
    [Rule "can't go that way rule" applies.]
    [Rule "move player and vehicle rule" applies.]
    [Rule "move floating objects rule" applies.]
    [Rule "check light in new location rule" applies.]
    [Rule "After Drake going" applies.]

>undo
Corridor of Contemplation
[Previous turn undone.]

* * *

>actions
Actions listing on.

>e
[Rule "standard set going variables rule" applies.]
[going east]
    [Rule "Before going through a closed door ( called the obstacle )" applies.]
    [Rule "Rule for implicitly opening the Abbot's Door when Introduction has ended" applies.]
[(1) opening the Abbot's Door - silently]
    [Rule "can't open unless openable rule" applies.]
    [Rule "can't open what's locked rule" applies.]
    [Rule "can't open what's already open rule" applies.]
    [Rule "standard opening rule" applies.]
    [Rule "After opening the Abbot's Door when Introduction has ended and the location is the Corridor of Contemplation" applies.]
[(2) entering the Abbot's Door - silently]
     [Rule "convert enter door into go rule" applies.]
     [Rule "standard set going variables rule" applies.]
[(3) going the Abbot's Door - silently]
     [Rule "can't travel in what's not a vehicle rule" applies.]
     [Rule "can't go through undescribed doors rule" applies.]
     [Rule "can't go through closed doors rule" applies.]
     [Rule "determine map connection rule" applies.]
     [Rule "can't go that way rule" applies.]
     [Rule "move player and vehicle rule" applies.]
     [Rule "move floating objects rule" applies.]
     [Rule "check light in new location rule" applies.]
[(3) going the Abbot's Door - silently - succeeded]
[(2) entering the Abbot's Door - silently - succeeded]
[(1) opening the Abbot's Door - silently - succeeded]
    [Rule "can't travel in what's not a vehicle rule" applies.]
I"ll have to get out of the Abbot's Quarters first.
[going east - failed the can't travel in what's not a vehicle rule]

[Rule "Every turn during Drake's Patrol" applies.]
[Rule "standard set going variables rule" applies.]
[Drake going east]
    [Rule "can't travel in what's not a vehicle rule" applies.]
    [Rule "can't go through undescribed doors rule" applies.]
    [Rule "can't go through closed doors rule" applies.]
    [Rule "determine map connection rule" applies.]
    [Rule "can't go that way rule" applies.]
    [Rule "move player and vehicle rule" applies.]
    [Rule "move floating objects rule" applies.]
    [Rule "check light in new location rule" applies.]
    [Rule "After Drake going" applies.]
[Drake going east - succeeded]

* * *

>actions
Actions listing on.

>e
[going east]
[(1) opening the Abbot's Door - silently]
[(2) going the Abbot's Door - silently]
[(2) going the Abbot's Door - silently - succeeded]
[(1) opening the Abbot's Door - silently - succeeded]
I"ll have to get out of the Abbot's Quarters first.
[going east - failed the can't travel in what's not a vehicle rule]

[Drake going east]
[Drake going east - succeeded]

* * *

>e
I knock before entering the Abbot's study.

Abbot's Quarters
The Abbot's Quarters again. Gubbler is here, standing by his desk (no chair, remember?). He's looking right at me, waiting for me to explain why I'm interrupting him, and why I haven't run away back west yet.

Gubbler coughs into a fist. "Well, yes?" he demands.

>x gubbler
Gubbler's staring right at me, or maybe just past my shoulder. He doesn't look very happy. His mechanical salamander is climbing restlessly over his shoulders.

>x salamander
The salamander is a wind-up pet of Gubbler's. It ratchets a little as it scurries, and near anything steep - like his upper arms - it waggles its feet uselessly and slides back down.

Gubbler coughs into a fist. "Well, yes?" he demands.

>x desk
Gubbler's desk is bare and old. The surface is scratched a little with geometric designs.

>ask gubbler about horloge
"Tell me about Brother Horloge," I ask.

"When the time comes for you to start Reading," the Abbot says firmly, "then you'll get to know Brother Horloge. Till then, you've got your chores to do. This Abbey won't clean itself."

>ask gubbler about horloge
I've already asked about that.

>ask gubbler about tea
"Should I get you some tea?" I ask.

"Tea? I'm not one for tea," he says. "Horloge is the great addict around here."

The salamander buzzes up and down and around Gubbler's arms, using its tail to keep balance.

>z
Time passes.

>z
Time passes.

Gubbler looks like a man disturbed from work, or possibly from sleep. But I can't see any work on his desk.

>z
Time passes.

>z
Time passes.

The salamander is moving more sluggishly now as it crawls over Gubbler's back.

>z
Time passes.

>z
Time passes.

The salamander creeps down off Gubbler's hand and onto the desk, where it eventually grinds to a halt.

>x gubbler
Gubbler's staring right at me, or maybe just past my shoulder. He doesn't look very happy. His mechanical salamander is sitting motionless on the desk.

>stroke salamander
That's not a verb I recognize.

>l;
That's not a verb I recognize.

>l
Abbot's Quarters
The Abbot's Quarters again. Gubbler is here, standing by his desk (no chair, remember?). He's looking right at me, waiting for me to explain why I'm interrupting him, and why I haven't run away back west yet.

St. Newton is staring at the Abbot's unpolished Grandfather clock with a severe frown.

>z
Time passes.

>z
Time passes.

Gubbler fishes in a pocket, produces a key and stabs the creature in the side. A moment later it's frisking about as before.

>z
Time passes.

I beg your pardon?

* * *

>z
Time passes.

>z
Time passes.

Gubbler shivers a little. The sun has moved away from his window.

* * *

>e
I knock before entering the Abbot's study.

Abbot's Quarters
The Abbot's Quarters again. Gubbler is here, standing by his desk (no chair, remember?). He's looking right at me, waiting for me to explain why I'm interrupting him, and why I haven't run away back west yet.

Gubbler coughs into a fist. "Well, yes?" he demands.

>open clock
I open the clock door and peek inside. For a big clock it's got a pretty small penduluum, about the size of Calvin's fist and not as big as Drake's. There's even enough space in front of it for the Abbot to hang up one of his spare robes.

>wear robes
I can't see any such thing.

>wear robe
One day, maybe, once I've worked my way up to the status of clock-watcher and can start learning the Twelve Devotions. But not yet.

I beg your pardon?

* * *

>z
Time passes.

>z
Time passes.

The salamander buzzes up and down and around Gubbler's arms, using its tail to keep balance.

>z
Time passes.

* * *

>z
Time passes.

The salamander is moving more sluggishly now as it crawls over Gubbler's back.

>l
Abbot's Quarters
The Abbot's Quarters again. Gubbler is here, standing by his desk (no chair, remember?). He's looking right at me, waiting for me to explain why I'm interrupting him, and why I haven't run away back west yet.

St. Newton is staring at the Abbot's unpolished Grandfather clock with a severe frown.

* * *

>e
I knock before entering the Abbot's study.

Abbot's Quarters
The Abbot's Quarters again. Gubbler is here, standing by his desk (no chair, remember?). He's looking right at me, waiting for me to explain why I'm interrupting him, and why I haven't run away back west yet.

Gubbler coughs into a fist. "Well, yes?" he demands.

>w
Corridor of Contemplation
The ancient stones of the Abbey rise to about shoulder-height before arching over, forcing me to bow my head in supplication before the Abbot's door, back east. To the west, I can hear the gentle echo of ticks and tocks coming from the Abbey's main hall.

Carved into the walls are a series of pious engravings, depicting the long path from initiate to Abbot.

>w
Lower Hall
Looking northeast, the Great Hall of the Abbey stretches away like the belly of some big beast, its bony roof held up by pillars like swallowed trees. The walls are carelessly lit by candles moving through Sacred Tracks suspended in the air. I can just make out the Corridor of Contemplation to the east, and the wider archway to the Scriptorium to the west.

But more importantly, the great Entry - and exit - of the Abbey is to the southwest. And if I'm going to get out of here and talk to the Archbishop that's the only way to go.

But maybe you're starting to see what kind of luck I have. Right there, in the Entry, is Calvin, working on a clock.

Distantly - but not distantly enough - I can hear the clock and clatter of Drake's boots. The sound's coming from the northeast.

>sw
What, just waltz past him, stop and say hi? He'd have me by the hair in moments. No, I need some kind of plan to get past him.

Drake's just off to the northeast, and he's coming this way!

>e
Corridor of Contemplation
The ancient stones of the Abbey rise to about shoulder-height before arching over, forcing me to bow my head in supplication before the Abbot's door, back east. To the west, I can hear the gentle echo of ticks and tocks coming from the Abbey's main hall.

Carved into the walls are a series of pious engravings, depicting the long path from initiate to Abbot.

Calvin will be there till the Refectory Clock chimes for dinner. And that, slow and sure as clockwork, has given me an idea. The Refectory Clock…

>e
I knock before entering the Abbot's study.

Abbot's Quarters
The Abbot's Quarters again. Gubbler is here, standing by his desk (no chair, remember?). He's looking right at me, waiting for me to explain why I'm interrupting him, and why I haven't run away back west yet.

>w
Corridor of Contemplation
The ancient stones of the Abbey rise to about shoulder-height before arching over, forcing me to bow my head in supplication before the Abbot's door, back east. To the west, I can hear the gentle echo of ticks and tocks coming from the Abbey's main hall.

Carved into the walls are a series of pious engravings, depicting the long path from initiate to Abbot.

>sw
I can't go that way.

>w
Lower Hall
Looking northeast, the Great Hall of the Abbey stretches away like the belly of some big beast, its bony roof held up by pillars like swallowed trees. The walls are carelessly lit by candles moving through Sacred Tracks suspended in the air. I can just make out the Corridor of Contemplation to the east, and the wider archway to the Scriptorium to the west.

But more importantly, the great Entry - and exit - of the Abbey is to the southwest. And if I'm going to get out of here and talk to the Archbishop that's the only way to go.

But maybe you're starting to see what kind of luck I have. Right there, in the Entry, is Calvin, working on a clock.

>sw
What, just waltz past him, stop and say hi? He'd have me by the hair in moments. No, I need some kind of plan to get past him.

>e
Corridor of Contemplation
The ancient stones of the Abbey rise to about shoulder-height before arching over, forcing me to bow my head in supplication before the Abbot's door, back east. To the west, I can hear the gentle echo of ticks and tocks coming from the Abbey's main hall.

Carved into the walls are a series of pious engravings, depicting the long path from initiate to Abbot.

>e
I knock before entering the Abbot's study.

Abbot's Quarters
The Abbot's Quarters again. Gubbler is here, standing by his desk (no chair, remember?). He's looking right at me, waiting for me to explain why I'm interrupting him, and why I haven't run away back west yet.

St. Newton is staring at the Abbot's unpolished Grandfather clock with a severe frown.

>jump
I jump on the spot, fruitlessly.

* * *

>w
Corridor of Contemplation
The ancient stones of the Abbey rise to about shoulder-height before arching over, forcing me to bow my head in supplication before the Abbot's door, back east. To the west, I can hear the gentle echo of ticks and tocks coming from the Abbey's main hall.

Carved into the walls are a series of pious engravings, depicting the long path from initiate to Abbot.

>w
Lower Hall
Looking northeast, the Great Hall of the Abbey stretches away like the belly of some big beast, its bony roof held up by pillars like swallowed trees. The walls are carelessly lit by candles moving through Sacred Tracks suspended in the air. I can just make out the Corridor of Contemplation to the east, and the wider archway to the Scriptorium to the west.

But more importantly, the great Entry - and exit - of the Abbey is to the southwest. And if I'm going to get out of here and talk to the Archbishop that's the only way to go.

But maybe you're starting to see what kind of luck I have. Right there, in the Entry, is Calvin, working on a clock.

>x calvin
He's hard at work - or he is whenever a monk goes past, anyway. The rest of the time he's fiddling with his hair in the reflection of the bits he's polished so far. I'm not going to be able to slip past him like that. I'm going to need to get him out of there somehow.

>ask calvin about tea
There is no reply.

>ne
Central Hall
I'm standing in the very centre of the Abbey's Great Hall. It's impossible not to crane my neck here, to gaze up at the ceiling held aloft by buttresses like gigantic oak trees. To think, people built this in the days before proper pulley-transmissions! It must have taken weeks! The hall continues northeast into shadow, and southwest, towards the sunlight, the Yard and above all, the Archbishop.

The vast empty space is filled by the muttering and echo of Holy Mechanisms, and the hiss of the candles as they sweep around their Tracks, providing a little light everywhere but rarely ever enough. I can just make out archways both east and west.

Drake's on patrol, and I can hear him heading this way, from the northeast.

>e
West Refectory
I spend some of my time here, eating at one of the two long tables. I spend even more serving the monks. Each of them has their own seat, marked by a little brass hourglass, and if the twenty or so I can see here weren't enough (which they aren't), there's more to the east, where the Refectory continues. Back west is the archway to the Great Hall.

On the table is a single empty teacup, left over from breakfast.

* * *

>e
West Refectory
I spend some of my time here, eating at one of the two long tables. I spend even more serving the monks. Each of them has their own seat, marked by a little brass hourglass, and if the twenty or so I can see here weren't enough (which they aren't), there's more to the east, where the Refectory continues. Back west is the archway to the Great Hall.

Drake's on patrol, and I can hear him heading this way, from the west.

>w
I catch the sound of hobnailed boots. Drake's heading this way! I'd better wait, and let him pass.

Looking west, I can see Drake. He's coming this way!

>undo
West Refectory
[Previous turn undone.]

>undo
Central Hall
[Previous turn undone.]

* * *

>e
Central Hall
I'm standing in the very centre of the Abbey's Great Hall. It's impossible not to crane my neck here, to gaze up at the ceiling held aloft by buttresses like gigantic oak trees. To think, people built this in the days before proper pulley-transmissions! It must have taken weeks! The hall continues northeast into shadow, and southwest, towards the sunlight, the Yard and above all, the Archbishop.

The vast empty space is filled by the muttering and echo of Holy Mechanisms, and the hiss of the candles as they sweep around their Tracks, providing a little light everywhere but rarely ever enough. I can just make out archways both east and west.

>ne
Upper Hall
The Great Hall of the Abbey is the biggest room I've seen in my life, running from this end all the way southwest (and it is all the way, I'm never allowed further) to the Great Doors and the Yard outside. If I crane my neck I can see the dark square of the floorboards of my room - the ladder is on one side, to the west. Lights move in and out overhead, from the candles moving on their Holy Tracks. Strong smells float through an archway to the east.

From their niches, the Three Major Saints are watching sternly, keen that I should get out of the Cathedral and talk to the Archbishop as quickly as possible.

I've got a moment before Drake spots me: he's just appeared, to the east.

>w
Rickety Stair
I'm in one corner of the Great Hall, just by the foot of the ladder up to my room. There's a note attached to it, asking Amble the caretaker not to put it back in the shed just yet.

* * *

>e
Kitchen
If there was ever a proof of the perfection of Clockwork over Nature, it's that the dirtiest and most hectic room in the whole Abbey is its Kitchen. Shelves, walls and floor are covered by machines belching, slicing, steaming, chopping, stirring, boiling, broiling, frying, pureeing … the list goes on. The noise, smell and heat is almost overpowering, and the Cook, who controls this madhouse, can only stand it because he's stone deaf.

In one corner is the only machine I'm allowed to use: the Tea Maker. There's a jar of tea leaf beside it. 

I can escape back into the cool of the Hall to the west. South, through a broad arch, is the Refectory.

The cook pushes past me, to tighten the grater.

>put tea in machine
(the tea leaves in the Tea Maker)
(first taking some tea from the jar)
The basket's now filled with tea leaves.

The cook scurries past me, to thump the whisker.

>put tea in machine
Which do I mean, the jar of tea leaves, the loose tea leaves (inside the jar), the Tea Machine or the teacup?

>loose
I need to be holding the tea leaves before I can put them into something else.

>put jar in machine
(first taking some tea from the jar)
The basket's now filled with tea leaves.

The cook pushes past me, to tighten the whisker.

Drake's clattering boots are audible to the south.

* * *

>put tea in machine
(the tea leaves in the Tea Maker)
(first taking some tea from the jar)
The basket's now filled with tea leaves.

The cook scurries past me, to thump the whisker.

>put cup in bracket
Done.

>turn spigot
The spigot releases a thin dribble of water into the kettle. Across the room, the clouds coming from the steamer suddenly thin out and the Cook pauses to give me the most evil of evil stares. I turn the spigot closed again.

Drake's clattering boots are audible to the south.

>wind key
(the tea maker key)
A few turns and the spring is fully wound.

Drake's just off to the south, and he's coming this way!

>w
Upper Hall
The Great Hall of the Abbey is the biggest room I've seen in my life, running from this end all the way southwest (and it is all the way, I'm never allowed further) to the Great Doors and the Yard outside. If I crane my neck I can see the dark square of the floorboards of my room - the ladder is on one side, to the west. Lights move in and out overhead, from the candles moving on their Holy Tracks. Strong smells float through an archway to the east.

From their niches, the Three Major Saints are watching sternly, keen that I should get out of the Cathedral and talk to the Archbishop as quickly as possible.

I've got a moment before Drake spots me: he's just appeared, to the east.

* * *

>pull lever
The lever locks down and sets the first few gears in motion. But it doesn't seem to be carrying over correctly. I can't help but notice a worn down gear in the middle of the train, no longer catching teeth with its fellows. I make the sign of Sad Depreciation.

I release the lever and it springs back up.

>get gear
Which do I mean, the gear train or the small gear?

* * *

>small
While the Cook is distracted - the Cook is always distracted - I pluck the out the worn down gear. Not the sort of repair a clock polisher should be doing!

>sw
I can't go that way.

Drake's on patrol, and I can hear him heading this way, from the south.

>w
Upper Hall
The Great Hall of the Abbey is the biggest room I've seen in my life, running from this end all the way southwest (and it is all the way, I'm never allowed further) to the Great Doors and the Yard outside. If I crane my neck I can see the dark square of the floorboards of my room - the ladder is on one side, to the west. Lights move in and out overhead, from the candles moving on their Holy Tracks. Strong smells float through an archway to the east.

From their niches, the Three Major Saints are watching sternly, keen that I should get out of the Cathedral and talk to the Archbishop as quickly as possible.

Drake's clattering boots are audible to the east.

>sw
Central Hall
I'm standing in the very centre of the Abbey's Great Hall. It's impossible not to crane my neck here, to gaze up at the ceiling held aloft by buttresses like gigantic oak trees. To think, people built this in the days before proper pulley-transmissions! It must have taken weeks! The hall continues northeast into shadow, and southwest, towards the sunlight, the Yard and above all, the Archbishop.

The vast empty space is filled by the muttering and echo of Holy Mechanisms, and the hiss of the candles as they sweep around their Tracks, providing a little light everywhere but rarely ever enough. I can just make out archways both east and west.

Drake's footsteps echo in from the northeast.

>w
Library
The Abbey's library is small compared to the one in the Cathedral. There's nothing on the shelves but the key texts: the Principia, the Mechanistica and the Determininium. Only Brother Horloge, the Abbey's Primary Reader ever seems to use them - he's here at the moment, studying at his desk by the poor light coming through the stained glass windows. By his elbow is a fat bunch of keys. On his shoulder is his mechanical owl, wings folded.

An archway leads east back into the hall. From the southwest comes the clatter of Writing hammers and the sharp smell of burnt ink.

Horloge's finger shakes terribly as he traces the Holy Lines across the sheet.

>sw
Scriptorium
The Scriptorium is where the Copying takes place, though it's hard to believe that Copying once meant a team of monks working with carved rubber stamps. It's all done by mechanisms now, of course, like everything else except my chores. There's the massive Gutenberg press on the west wall, and everywhere else is Brother Reloh's Duplicator. Twenty-three Typewriters, all clattering away as though operated by ghosts, all connected by a single Carriage Arm that curves the length of the wall. To leave the room east or northeast I'll have to duck under.

Reloh works on one of the keyboards of the Duplicator, typing furiously. The hammering and punching is almost overwhelming.

The Gutenberg seems to be in the midst of a repair. The Cabinet of Relics next to it is open.

Drake's on patrol, and I can hear him heading this way, from the east.

>get new gear
"Put that back," Reloh snaps, without looking up. But I don't put it back.

Looking east, I can see Drake. He's coming this way!

>ne
Library
The Abbey's library is small compared to the one in the Cathedral. There's nothing on the shelves but the key texts: the Principia, the Mechanistica and the Determininium. Only Brother Horloge, the Abbey's Primary Reader ever seems to use them - he's here at the moment, studying at his desk by the poor light coming through the stained glass windows. By his elbow is a fat bunch of keys. On his shoulder is his mechanical owl, wings folded.

An archway leads east back into the hall. From the southwest comes the clatter of Writing hammers and the sharp smell of burnt ink.

I've got a moment before Drake spots me: he's just appeared, to the southwest.

>e
Central Hall
I'm standing in the very centre of the Abbey's Great Hall. It's impossible not to crane my neck here, to gaze up at the ceiling held aloft by buttresses like gigantic oak trees. To think, people built this in the days before proper pulley-transmissions! It must have taken weeks! The hall continues northeast into shadow, and southwest, towards the sunlight, the Yard and above all, the Archbishop.

The vast empty space is filled by the muttering and echo of Holy Mechanisms, and the hiss of the candles as they sweep around their Tracks, providing a little light everywhere but rarely ever enough. I can just make out archways both east and west.

Drake's just off to the west, and he's coming this way!

>ne
Upper Hall
The Great Hall of the Abbey is the biggest room I've seen in my life, running from this end all the way southwest (and it is all the way, I'm never allowed further) to the Great Doors and the Yard outside. If I crane my neck I can see the dark square of the floorboards of my room - the ladder is on one side, to the west. Lights move in and out overhead, from the candles moving on their Holy Tracks. Strong smells float through an archway to the east.

From their niches, the Three Major Saints are watching sternly, keen that I should get out of the Cathedral and talk to the Archbishop as quickly as possible.

>e
Kitchen
If there was ever a proof of the perfection of Clockwork over Nature, it's that the dirtiest and most hectic room in the whole Abbey is its Kitchen. Shelves, walls and floor are covered by machines belching, slicing, steaming, chopping, stirring, boiling, broiling, frying, pureeing … the list goes on. The noise, smell and heat is almost overpowering, and the Cook, who controls this madhouse, can only stand it because he's stone deaf.

In one corner is the only machine I'm allowed to use: the Tea Maker. There's a jar of tea leaf beside it. In the bracket of the machine is a teacup. 

I can escape back into the cool of the Hall to the west. South, through a broad arch, is the Refectory.

The cook knocks past me, to wind the masher.

Drake's footsteps echo in from the south.

>put new gear in machine
The gear train forms a perfect snake from the lever, over the semi-circular bracket and into the innards of the machine.

Looking south, I can see Drake. He's coming this way!

>w
Upper Hall
The Great Hall of the Abbey is the biggest room I've seen in my life, running from this end all the way southwest (and it is all the way, I'm never allowed further) to the Great Doors and the Yard outside. If I crane my neck I can see the dark square of the floorboards of my room - the ladder is on one side, to the west. Lights move in and out overhead, from the candles moving on their Holy Tracks. Strong smells float through an archway to the east.

From their niches, the Three Major Saints are watching sternly, keen that I should get out of the Cathedral and talk to the Archbishop as quickly as possible.

Drake's just off to the east, and he's coming this way!

* * *

>e
Kitchen
If there was ever a proof of the perfection of Clockwork over Nature, it's that the dirtiest and most hectic room in the whole Abbey is its Kitchen. Shelves, walls and floor are covered by machines belching, slicing, steaming, chopping, stirring, boiling, broiling, frying, pureeing … the list goes on. The noise, smell and heat is almost overpowering, and the Cook, who controls this madhouse, can only stand it because he's stone deaf.

In one corner is the only machine I'm allowed to use: the Tea Maker. There's a jar of tea leaf beside it. In the bracket of the machine is a teacup. 

I can escape back into the cool of the Hall to the west. South, through a broad arch, is the Refectory.

The cook scurries past me, to thump the grater.

>pull lever
The gear train whirrs into life, swinging the kettle across inside the machine. Its base knocks open the gas-pipe tap. A jet of gas hisses out, blowing up a tiny sail attached by thread to the flint-iron. The burner is quickly alight.

The cook pushes past me, to unclip the masher.

>z
Time passes.

After a minute or so, steam begins to rise from the kettle. This steam collects on a fine gauze over the kettle, which slowly weighs down on a thin metal strut. Eventually, the pressure is enough to flip a counterweight, and the gauze tilts, pushes the kettle onto its side. Boiling water pours from the spout and into the basket of tea leaves. As the kettle empties, its weight shifts and it swings back. A pin on one side knocks closed the gas pipe.

The cook scurries past me, to respring the whisker.

>z
Time passes.

The basket slows filters tea into the waiting cup. Meanwhile, the slowing gears move the kettle back to its original position below the spigot, and the water on the gauze sheet evaporates away. All is restored: "Every cog comes full circle," as they say.

Drake's clattering boots are audible to the south.

>get tea
(the tea leaves)
I scoop up a handful of tea leaves.

The lever springs back. The tea is finished. In a final convulsion, the machine spits the used tea leaves out the back and into a composter duct, ready to be fed to the cows that provided the gas… It's certainly neat.

The cook bustles past me, to tighten the steamer.

Looking south, I can see Drake. He's coming this way!

>undo
Kitchen
[Previous turn undone.]

>z
Time passes.

The lever springs back. The tea is finished. In a final convulsion, the machine spits the used tea leaves out the back and into a composter duct, ready to be fed to the cows that provided the gas… It's certainly neat.

Looking south, I can see Drake. He's coming this way!

>w
Upper Hall
The Great Hall of the Abbey is the biggest room I've seen in my life, running from this end all the way southwest (and it is all the way, I'm never allowed further) to the Great Doors and the Yard outside. If I crane my neck I can see the dark square of the floorboards of my room - the ladder is on one side, to the west. Lights move in and out overhead, from the candles moving on their Holy Tracks. Strong smells float through an archway to the east.

From their niches, the Three Major Saints are watching sternly, keen that I should get out of the Cathedral and talk to the Archbishop as quickly as possible.

I've got a moment before Drake spots me: he's just appeared, to the east.

* * *

>w
Library
The Abbey's library is small compared to the one in the Cathedral. There's nothing on the shelves but the key texts: the Principia, the Mechanistica and the Determininium. Only Brother Horloge, the Abbey's Primary Reader ever seems to use them - he's here at the moment, studying at his desk by the poor light coming through the stained glass windows. By his elbow is a fat bunch of keys. On his shoulder is his mechanical owl, wings folded.

An archway leads east back into the hall. From the southwest comes the clatter of Writing hammers and the sharp smell of burnt ink.

>give tea to horloge
I set the cup down beside Brother Horloge's elbow. "Excellent, there," he says, beaming, nostrils twitching. "Such a smell! The finest!" He lifts the cup, takes a sip and smacks his lips. "It's the slight metallic tang that really gives it the whotsit," he adds. His eyes half-close in calm delight.

Horloge is clearly enjoying his cup of tea.

>e
I catch the sound of hobnailed boots. Drake's heading this way! I'd better wait, and let him pass.

Horloge reaches up to stroke his owl. The bird is motionless.

>e
Just in time, I see Drake's there. I hang back, to let him move on.

Drake's on patrol, and I can hear him heading this way, from the southwest.

* * *

>ne
I catch the sound of hobnailed boots. Drake's heading this way! I'd better wait, and let him pass.

>w
Scriptorium
The Scriptorium is where the Copying takes place, though it's hard to believe that Copying once meant a team of monks working with carved rubber stamps. It's all done by mechanisms now, of course, like everything else except my chores. There's the massive Gutenberg press on the west wall, and everywhere else is Brother Reloh's Duplicator. Twenty-three Typewriters, all clattering away as though operated by ghosts, all connected by a single Carriage Arm that curves the length of the wall. To leave the room east or northeast I'll have to duck under.

Reloh works on one of the keyboards of the Duplicator, typing furiously. The hammering and punching is almost overwhelming.

The Gutenberg seems to be in the midst of a repair. The Cabinet of Relics next to it is open.

>ne
Library
The Abbey's library is small compared to the one in the Cathedral. There's nothing on the shelves but the key texts: the Principia, the Mechanistica and the Determininium. Only Brother Horloge, the Abbey's Primary Reader ever seems to use them - he's here at the moment, studying at his desk by the poor light coming through the stained glass windows. By his elbow is a fat bunch of keys. On his shoulder is his mechanical owl, wings folded.

An archway leads east back into the hall. From the southwest comes the clatter of Writing hammers and the sharp smell of burnt ink.

Horloge is clearly enjoying his cup of tea.

>get keys
His eyes are only half-closed. They're half-open as well. He bats my hand away firmly. "Leave them be," he says. Of course, he knocks them to the floor in the process and he doesn't notice that.

>get keys
Very quietly, I pick the keys up off the ground. With his eyes half-shut, Horloge doesn't notice.

>e
I catch the sound of hobnailed boots. Drake's heading this way! I'd better wait, and let him pass.

>e
Just in time, I see Drake's there. I hang back, to let him move on.

Drake's on patrol, and I can hear him heading this way, from the southwest.

* * *

>sw
I catch the sound of hobnailed boots. Drake's heading this way! I'd better wait, and let him pass.

>sw
Just in time, I see Drake's there. I hang back, to let him move on.

* * *

>e
West Refectory
I spend some of my time here, eating at one of the two long tables. I spend even more serving the monks. Each of them has their own seat, marked by a little brass hourglass, and if the twenty or so I can see here weren't enough (which they aren't), there's more to the east, where the Refectory continues. Back west is the archway to the Great Hall.

>e
East Refectory
The eastern end of the long Refectory is given over in part to the tables lined with brass hourglasses, but in the other half there's nothing but the enormous Refectory Clock. It's an impressive thing, so big because it only needs winding once a year, despite all the gongs, cymbals, tubes and bells that strike when dinner time comes around. Right now, the clock is showing the time at just after quarter to five.

Pungent smells drift in from the kitchen to the north. On the east wall is the small green door to the Abbey's herb garden.

>unlock clock
(with Horloge's Keys)
I unlock the Refectory Clock.

>wind clock to 5
Putting a clock wrong turns my stomach… but the thought of that Figure in Grey spurs me on. So I make the sign of the Winding Key - maybe that'll buy me some forgiveness when I wind down. Then I push the hands round to five o'clock.

The clash of metal on metal: the Refectory Clock leaps into life like an advancing army, its bells, gongs and organ pipes ringing and chiming and clanging away! Very, very quickly, I slam shut the clock case door and, covering my ears, rush over to the other side of the room. It's still horribly loud.

>w
West Refectory
I spend some of my time here, eating at one of the two long tables. I spend even more serving the monks. Each of them has their own seat, marked by a little brass hourglass, and if the twenty or so I can see here weren't enough (which they aren't), there's more to the east, where the Refectory continues. Back west is the archway to the Great Hall.

The stonework resounds with the sounds of gongs.

Calvin and Drake explode into the room and barge me out of the way as they race over to the East Refectory.

>w
Central Hall
I'm standing in the very centre of the Abbey's Great Hall. It's impossible not to crane my neck here, to gaze up at the ceiling held aloft by buttresses like gigantic oak trees. To think, people built this in the days before proper pulley-transmissions! It must have taken weeks! The hall continues northeast into shadow, and southwest, towards the sunlight, the Yard and above all, the Archbishop.

The vast empty space is filled by the muttering and echo of Holy Mechanisms, and the hiss of the candles as they sweep around their Tracks, providing a little light everywhere but rarely ever enough. I can just make out archways both east and west.

>sw
Lower Hall
Looking northeast, the Great Hall of the Abbey stretches away like the belly of some big beast, its bony roof held up by pillars like swallowed trees. The walls are carelessly lit by candles moving through Sacred Tracks suspended in the air. I can just make out the Corridor of Contemplation to the east, and the wider archway to the Scriptorium to the west.

But more importantly, the great Entry - and exit - of the Abbey is to the southwest. And if I'm going to get out of here and talk to the Archbishop that's the only way to go.

>sw
Entry
Sunlight and the sound of the city of St Philip pour in from the west through the Abbey's great doors. At last! I can get away and see the Archbishop!... before whatever happens happens.

To the east, a cloister runs towards the cells of the monks, novices, initiates, unaffiliated staff - really, of everyone apart from me.

I can see an Entry Clock and a Cloister here.

Gongs, bells and all manner of noises are echoing around the walls.

>e
I can't, since the Cloister is in the way.

>open cloister
I open the Cloister.

>e
I can't, since the Cloister leads nowhere.

>actions
Actions listing on.

>e
[going east]
I can't, since the Cloister leads nowhere.
[going east - failed the can't go that way rule]

>w
[going west]
I can't, since the Abbey Doors is in the way.
[going west - failed the can't go through closed doors rule]

* * *

>ne
Upper Hall
The Great Hall of the Abbey is the biggest room I've seen in my life, running from this end all the way southwest (and it is all the way, I'm never allowed further) to the Great Doors and the Yard outside. If I crane my neck I can see the dark square of the floorboards of my room - the ladder is on one side, to the west. Lights move in and out overhead, from the candles moving on their Holy Tracks. Strong smells float through an archway to the east.

From their niches, the Three Major Saints are watching sternly, keen that I should get out of the Cathedral and talk to the Archbishop as quickly as possible.

* * *

>ge
That's not a verb I recognize.

>e
Central Hall
I'm standing in the very centre of the Abbey's Great Hall. It's impossible not to crane my neck here, to gaze up at the ceiling held aloft by buttresses like gigantic oak trees. To think, people built this in the days before proper pulley-transmissions! It must have taken weeks! The hall continues northeast into shadow, and southwest, towards the sunlight, the Yard and above all, the Archbishop.

The vast empty space is filled by the muttering and echo of Holy Mechanisms, and the hiss of the candles as they sweep around their Tracks, providing a little light everywhere but rarely ever enough. I can just make out archways both east and west.

Looking northeast, I can see Drake. He's coming this way!

* * *

>e
West Refectory
I spend some of my time here, eating at one of the two long tables. I spend even more serving the monks. Each of them has their own seat, marked by a little brass hourglass, and if the twenty or so I can see here weren't enough (which they aren't), there's more to the east, where the Refectory continues. Back west is the archway to the Great Hall.

>e
East Refectory
The eastern end of the long Refectory is given over in part to the tables lined with brass hourglasses, but in the other half there's nothing but the enormous Refectory Clock. It's an impressive thing, so big because it only needs winding once a year, despite all the gongs, cymbals, tubes and bells that strike when dinner time comes around. Right now, the clock is showing the time at just after twenty-five to four.

Pungent smells drift in from the kitchen to the north. On the east wall is the small green door to the Abbey's herb garden.

>n
Kitchen
If there was ever a proof of the perfection of Clockwork over Nature, it's that the dirtiest and most hectic room in the whole Abbey is its Kitchen. Shelves, walls and floor are covered by machines belching, slicing, steaming, chopping, stirring, boiling, broiling, frying, pureeing … the list goes on. The noise, smell and heat is almost overpowering, and the Cook, who controls this madhouse, can only stand it because he's stone deaf.

In one corner is the only machine I'm allowed to use: the Tea Maker. There's a jar of tea leaf beside it. 

I can escape back into the cool of the Hall to the west. South, through a broad arch, is the Refectory.

>put cup in bracket
Done.

The cook scurries past me, to respring the masher.

>put tea leaves in basket
(the tea leaves in the basket)
(first taking some tea from the jar)
The basket's now filled with tea leaves.

>wind key
(the tea maker key)
A few turns and the spring is fully wound.

The cook bustles past me, to wind the steamer.

>fill kettle
The spigot releases a thin dribble of water into the kettle. Across the room, the clouds coming from the steamer suddenly thin out and the Cook pauses to give me the most evil of evil stares. I turn the spigot closed again.

>get gear
(the small gear)
While the Cook is distracted - the Cook is always distracted - I pluck the out the worn down gear. Not the sort of repair a clock polisher should be doing!

Drake's on patrol, and I can hear him heading this way, from the south.

>small
That's not a verb I recognize.

>w
Upper Hall
The Great Hall of the Abbey is the biggest room I've seen in my life, running from this end all the way southwest (and it is all the way, I'm never allowed further) to the Great Doors and the Yard outside. If I crane my neck I can see the dark square of the floorboards of my room - the ladder is on one side, to the west. Lights move in and out overhead, from the candles moving on their Holy Tracks. Strong smells float through an archway to the east.

From their niches, the Three Major Saints are watching sternly, keen that I should get out of the Cathedral and talk to the Archbishop as quickly as possible.

Drake's clattering boots are audible to the east.

* * *

>sw
Lower Hall
Looking northeast, the Great Hall of the Abbey stretches away like the belly of some big beast, its bony roof held up by pillars like swallowed trees. The walls are carelessly lit by candles moving through Sacred Tracks suspended in the air. I can just make out the Corridor of Contemplation to the east, and the wider archway to the Scriptorium to the west.

But more importantly, the great Entry - and exit - of the Abbey is to the southwest. And if I'm going to get out of here and talk to the Archbishop that's the only way to go.

But maybe you're starting to see what kind of luck I have. Right there, in the Entry, is Calvin, working on a clock.

Drake's on patrol, and I can hear him heading this way, from the northeast.

>w
Scriptorium
The Scriptorium is where the Copying takes place, though it's hard to believe that Copying once meant a team of monks working with carved rubber stamps. It's all done by mechanisms now, of course, like everything else except my chores. There's the massive Gutenberg press on the west wall, and everywhere else is Brother Reloh's Duplicator. Twenty-three Typewriters, all clattering away as though operated by ghosts, all connected by a single Carriage Arm that curves the length of the wall. To leave the room east or northeast I'll have to duck under.

Reloh works on one of the keyboards of the Duplicator, typing furiously. The hammering and punching is almost overwhelming.

The Gutenberg seems to be in the midst of a repair. The Cabinet of Relics next to it is open.

Drake's clattering boots are audible to the east.

* * *

>get new gear
"Put that back," Reloh snaps, without looking up. But I don't put it back.

Drake's just off to the east, and he's coming this way!

>ne
Library
The Abbey's library is small compared to the one in the Cathedral. There's nothing on the shelves but the key texts: the Principia, the Mechanistica and the Determininium. Only Brother Horloge, the Abbey's Primary Reader ever seems to use them - he's here at the moment, studying at his desk by the poor light coming through the stained glass windows. By his elbow is a fat bunch of keys. On his shoulder is his mechanical owl, wings folded.

An archway leads east back into the hall. From the southwest comes the clatter of Writing hammers and the sharp smell of burnt ink.

Looking southwest, I can see Drake. He's coming this way!

>e
Central Hall
I'm standing in the very centre of the Abbey's Great Hall. It's impossible not to crane my neck here, to gaze up at the ceiling held aloft by buttresses like gigantic oak trees. To think, people built this in the days before proper pulley-transmissions! It must have taken weeks! The hall continues northeast into shadow, and southwest, towards the sunlight, the Yard and above all, the Archbishop.

The vast empty space is filled by the muttering and echo of Holy Mechanisms, and the hiss of the candles as they sweep around their Tracks, providing a little light everywhere but rarely ever enough. I can just make out archways both east and west.

Drake's just off to the west, and he's coming this way!

* * *

>e
West Refectory
I spend some of my time here, eating at one of the two long tables. I spend even more serving the monks. Each of them has their own seat, marked by a little brass hourglass, and if the twenty or so I can see here weren't enough (which they aren't), there's more to the east, where the Refectory continues. Back west is the archway to the Great Hall.

>e
East Refectory
The eastern end of the long Refectory is given over in part to the tables lined with brass hourglasses, but in the other half there's nothing but the enormous Refectory Clock. It's an impressive thing, so big because it only needs winding once a year, despite all the gongs, cymbals, tubes and bells that strike when dinner time comes around. Right now, the clock is showing the time at just after ten to four.

Pungent smells drift in from the kitchen to the north. On the east wall is the small green door to the Abbey's herb garden.

>n
Kitchen
If there was ever a proof of the perfection of Clockwork over Nature, it's that the dirtiest and most hectic room in the whole Abbey is its Kitchen. Shelves, walls and floor are covered by machines belching, slicing, steaming, chopping, stirring, boiling, broiling, frying, pureeing … the list goes on. The noise, smell and heat is almost overpowering, and the Cook, who controls this madhouse, can only stand it because he's stone deaf.

In one corner is the only machine I'm allowed to use: the Tea Maker. There's a jar of tea leaf beside it. In the bracket of the machine is a teacup. 

I can escape back into the cool of the Hall to the west. South, through a broad arch, is the Refectory.

>put new gear in train
The gear train forms a perfect snake from the lever, over the semi-circular bracket and into the innards of the machine.

The cook scurries past me, to respring the crumb-sucker.

>pull lever
The gear train whirrs into life, swinging the kettle across inside the machine. Its base knocks open the gas-pipe tap. A jet of gas hisses out, blowing up a tiny sail attached by thread to the flint-iron. The burner is quickly alight.

>undo
Kitchen
[Previous turn undone.]

>use machine
You will have to be more specific about your intentions.

The cook pushes past me, to tighten the masher.

>undo
Kitchen
[Previous turn undone.]

* * *

>put new gear in train
The gear train forms a perfect snake from the lever, over the semi-circular bracket and into the innards of the machine.

The cook scurries past me, to respring the crumb-sucker.

>use machine
It does no good to talk to a machine so casually, as Gubbler would say. Each sacred part must be treated as an individual operating within a larger purpose. Keys must be wound, levers pulled, spigots opened… that sort of thing.

>pull lever
The gear train whirrs into life, swinging the kettle across inside the machine. Its base knocks open the gas-pipe tap. A jet of gas hisses out, blowing up a tiny sail attached by thread to the flint-iron. The burner is quickly alight.

>z
Time passes.

After a minute or so, steam begins to rise from the kettle. This steam collects on a fine gauze over the kettle, which slowly weighs down on a thin metal strut. Eventually, the pressure is enough to flip a counterweight, and the gauze tilts, pushes the kettle onto its side. Boiling water pours from the spout and into the basket of tea leaves. As the kettle empties, its weight shifts and it swings back. A pin on one side knocks closed the gas pipe.

>z
Time passes.

The basket slows filters tea into the waiting cup. Meanwhile, the slowing gears move the kettle back to its original position below the spigot, and the water on the gauze sheet evaporates away. All is restored: "Every cog comes full circle," as they say.

The cook knocks past me, to tighten the broiler.

Drake's footsteps echo in from the south.

>z
Time passes.

The lever springs back. The tea is finished. In a final convulsion, the machine spits the used tea leaves out the back and into a composter duct, ready to be fed to the cows that provided the gas… It's certainly neat.

The cook scurries past me, to wind the whisker.

I've got a moment before Drake spots me: he's just appeared, to the south.

>w
Upper Hall
The Great Hall of the Abbey is the biggest room I've seen in my life, running from this end all the way southwest (and it is all the way, I'm never allowed further) to the Great Doors and the Yard outside. If I crane my neck I can see the dark square of the floorboards of my room - the ladder is on one side, to the west. Lights move in and out overhead, from the candles moving on their Holy Tracks. Strong smells float through an archway to the east.

From their niches, the Three Major Saints are watching sternly, keen that I should get out of the Cathedral and talk to the Archbishop as quickly as possible.

Drake's just off to the east, and he's coming this way!

* * *

>w
Library
The Abbey's library is small compared to the one in the Cathedral. There's nothing on the shelves but the key texts: the Principia, the Mechanistica and the Determininium. Only Brother Horloge, the Abbey's Primary Reader ever seems to use them - he's here at the moment, studying at his desk by the poor light coming through the stained glass windows. By his elbow is a fat bunch of keys. On his shoulder is his mechanical owl, wings folded.

An archway leads east back into the hall. From the southwest comes the clatter of Writing hammers and the sharp smell of burnt ink.

>put teacup on table
I set the cup down beside Brother Horloge's elbow. "Excellent, there," he says, beaming, nostrils twitching. "Such a smell! The finest!" He lifts the cup, takes a sip and smacks his lips. "It's the slight metallic tang that really gives it the whotsit," he adds. His eyes half-close in calm delight.

Horloge is clearly enjoying his cup of tea.

>get keys
His eyes are only half-closed. They're half-open as well. He bats my hand away firmly. "Leave them be," he says. Of course, he knocks them to the floor in the process and he doesn't notice that.

>get keys
Very quietly, I pick the keys up off the ground. With his eyes half-shut, Horloge doesn't notice.

Drake's clattering boots are audible to the southwest.

>e
Central Hall
I'm standing in the very centre of the Abbey's Great Hall. It's impossible not to crane my neck here, to gaze up at the ceiling held aloft by buttresses like gigantic oak trees. To think, people built this in the days before proper pulley-transmissions! It must have taken weeks! The hall continues northeast into shadow, and southwest, towards the sunlight, the Yard and above all, the Archbishop.

The vast empty space is filled by the muttering and echo of Holy Mechanisms, and the hiss of the candles as they sweep around their Tracks, providing a little light everywhere but rarely ever enough. I can just make out archways both east and west.

Drake's on patrol, and I can hear him heading this way, from the west.

* * *

>e
East Refectory
The eastern end of the long Refectory is given over in part to the tables lined with brass hourglasses, but in the other half there's nothing but the enormous Refectory Clock. It's an impressive thing, so big because it only needs winding once a year, despite all the gongs, cymbals, tubes and bells that strike when dinner time comes around. Right now, the clock is showing the time at just after twenty past four.

Pungent smells drift in from the kitchen to the north. On the east wall is the small green door to the Abbey's herb garden.

>unlock case
(with Horloge's Keys)
I unlock the Refectory Clock.

>set clock to 5pm
I didn't understand that time.

>set clock to 5 pm
Putting a clock wrong turns my stomach… but the thought of that Figure in Grey spurs me on. So I make the sign of the Winding Key - maybe that'll buy me some forgiveness when I wind down. Then I push the hands round to five o'clock.

The clash of metal on metal: the Refectory Clock leaps into life like an advancing army, its bells, gongs and organ pipes ringing and chiming and clanging away! Very, very quickly, I slam shut the clock case door and, covering my ears, rush over to the other side of the room. It's still horribly loud.

>x clock
The Refectory Clock is pounding out a colossal amount of noise!

Calvin and Drake have raced into the West Refectory. "Wren?" Drake shouts. "Turn that thing off! It's not dinner yet!"

I put one hand to my ear, as if I couldn't hear him at all.

>turn off clock
That's not something I can switch.

Calvin and Drake race over to the clock and start struggling with the case. Both are hampered by keeping their hands over both their ears at the same time.

I slip away quietly into the Kitchen.

Kitchen
If there was ever a proof of the perfection of Clockwork over Nature, it's that the dirtiest and most hectic room in the whole Abbey is its Kitchen. Shelves, walls and floor are covered by machines belching, slicing, steaming, chopping, stirring, boiling, broiling, frying, pureeing … the list goes on. The noise, smell and heat is almost overpowering, and the Cook, who controls this madhouse, can only stand it because he's stone deaf.

I can escape back into the cool of the Hall to the west. South, through a broad arch, is the Refectory, where the Refectory Clock is throwing up a wall of sound.

The cook bustles past me, to thump the broiler.

>x machine
Very complex, but robustly built and able to perform its functions a few thousand times without needing to be oiled. It consists of a framework of arms and struts, most of which move, though there's a plate at the front to hold the primary gear-train that's between the lever and the winding key. Inside the machine I can make out a kettle, a spigot, and a basket suspended over a semi-circular bracket. There's a burner somewhere, too.

>undo
Kitchen
[Previous turn undone.]

>rules
Rules tracing now switched on. Type "rules off" to switch it off again, or "rules all" to include even rules which do not apply.

>x machine
[Rule "examine undescribed containers rule" applies.]
    [Rule "examine undescribed devices rule" applies.]
    [Rule "examine undescribed things rule" applies.]
    [Rule "new examine directions rule" applies.]
    [Rule "standard examining rule" applies.]
Very complex, but robustly built and able to perform its functions a few thousand times without needing to be oiled. It consists of a framework of arms and struts, most of which move, though there's a plate at the front to hold the primary gear-train that's between the lever and the winding key. Inside the machine I can make out a kettle, a spigot, and a basket suspended over a semi-circular bracket. There's a burner somewhere, too.

    [Rule "examine described devices rule" applies.]
The Tea Maker is currently switched off.

    [Rule "report other people examining rule" applies.]
[Rule "Every turn when a random chance of 1 in 4 succeeds during Gong Sounding" applies.]
The stonework resounds with the sounds of gongs.

[Rule "Every turn when the player can see the Cook and a random chance of 1 in 3 succeeds" applies.]
The cook pushes past me, to unclip the whisker.

* * *

>x machine
Very complex, but robustly built and able to perform its functions a few thousand times without needing to be oiled. It consists of a framework of arms and struts, most of which move, though there's a plate at the front to hold the primary gear-train that's between the lever and the winding key. Inside the machine I can make out a kettle, a spigot, and a basket suspended over a semi-circular bracket. There's a burner somewhere, too.

>w
Upper Hall
The Great Hall of the Abbey is the biggest room I've seen in my life, running from this end all the way southwest (and it is all the way, I'm never allowed further) to the Great Doors and the Yard outside. If I crane my neck I can see the dark square of the floorboards of my room - the ladder is on one side, to the west. Lights move in and out overhead, from the candles moving on their Holy Tracks. Strong smells float through an archway to the east.

From their niches, the Three Major Saints are watching sternly, keen that I should get out of the Cathedral and talk to the Archbishop as quickly as possible.

* * *

>sw
Lower Hall
Looking northeast, the Great Hall of the Abbey stretches away like the belly of some big beast, its bony roof held up by pillars like swallowed trees. The walls are carelessly lit by candles moving through Sacred Tracks suspended in the air. I can just make out the Corridor of Contemplation to the east, and the wider archway to the Scriptorium to the west.

But more importantly, the great Entry - and exit - of the Abbey is to the southwest. And if I'm going to get out of here and talk to the Archbishop that's the only way to go.

>sw
Entry
Sunlight and the sound of the city of St Philip pour in from the west through the Abbey's great doors. At last! I can get away and see the Archbishop!... before whatever happens happens.

To the east, a cloister runs towards the cells of the monks, novices, initiates, unaffiliated staff - really, of everyone apart from me.

>e
No time to waste here. Calvin will be back as soon as they turn the clock off.

>x clock
The great Entry Clock is tall and thin and just about visible from the street. It's half-polished. A shoddy job, but I don't have time to fix it.

>x cloister
That way lies the cells where everyone else sleeps.

>x cloisters
That way lies the cells where everyone else sleeps.

The Abbey has turned into a giant trumpet, echoing the sound of bells.

>ne
Lower Hall
Looking northeast, the Great Hall of the Abbey stretches away like the belly of some big beast, its bony roof held up by pillars like swallowed trees. The walls are carelessly lit by candles moving through Sacred Tracks suspended in the air. I can just make out the Corridor of Contemplation to the east, and the wider archway to the Scriptorium to the west.

But more importantly, the great Entry - and exit - of the Abbey is to the southwest. And if I'm going to get out of here and talk to the Archbishop that's the only way to go.

>sw
Entry
Sunlight and the sound of the city of St Philip pour in from the west through the Abbey's great doors. At last! I can get away and see the Archbishop!... before whatever happens happens.

To the east, a cloister runs towards the cells of the monks, novices, initiates, unaffiliated staff - really, of everyone apart from me.

>w
Cathedral Yard
The Yard is where we go on Saturday's for exercise, cleaning up the muck left behind by the market (worse once a month when the horse-traders from the south come up and leave presents behind for the Abbey gardens). Today its quiet, at least, with the space between the Abbey to the east and the Cathedral to the west empty but for the usual collection of beggars, unfortunates, wretches and the disadvantaged poor.

The Cathedral really is enormous - but it doesn't have many rooms, so finding the Archbishop shouldn't take too long. Which is lucky, because I don't know how long I've got before Gubbler - and the mysterious Figure - put their plan into action. I've got to warn someone soon.

>l
Cathedral Yard
The Yard is where we go on Saturday's for exercise, cleaning up the muck left behind by the market (worse once a month when the horse-traders from the south come up and leave presents behind for the Abbey gardens). Today its quiet, at least, with the space between the Abbey to the east and the Cathedral to the west empty but for the usual collection of beggars, unfortunates, wretches and the disadvantaged poor.

>e
Entry
Sunlight and the sound of the city of St Philip pour in from the west through the Abbey's great doors. At last! I can get away and see the Archbishop!... before whatever happens happens.

To the east, a cloister runs towards the cells of the monks, novices, initiates, unaffiliated staff - really, of everyone apart from me.

>w
Cathedral Yard
The Yard is where we go on Saturday's for exercise, cleaning up the muck left behind by the market (worse once a month when the horse-traders from the south come up and leave presents behind for the Abbey gardens). Today its quiet, at least, with the space between the Abbey to the east and the Cathedral to the west empty but for the usual collection of beggars, unfortunates, wretches and the disadvantaged poor.

* * *

>sw
Entry
Sunlight and the sound of the city of St Philip pour in from the west through the Abbey's great doors. At last! I can get away and see the Archbishop!... before whatever happens happens.

To the east, a cloister runs towards the cells of the monks, novices, initiates, unaffiliated staff - really, of everyone apart from me.

>w
Cathedral Yard
The Yard is where we go on Saturday's for exercise, cleaning up the muck left behind by the market (worse once a month when the horse-traders from the south come up and leave presents behind for the Abbey gardens). Today it's quiet, at least, with the space between the Abbey to the east and the Cathedral to the west empty but for the usual collection of beggars, unfortunates, wretches and the disadvantaged poor.

The Cathedral really is enormous - but it doesn't have many rooms, so finding the Archbishop shouldn't take too long. Which is lucky, because I don't know how long I've got before Gubbler - and the mysterious Figure - put their plan into action. I've got to warn someone soon.

>w
Great Door
Imagine an ant crawling up inside a daffodil. That's what it's like here, and this is just the Entry to the massive Cathedral further north (I guess in there you'll need to imagine an ant inside a church bell).

Let me try and do better. The main doors south are about as tall as the Abbey itself, so they need a lot of space just to fit the hinges in (those are about as big as me, I think). I came in from the Yard by the east door; there's another similar door west but it's locked right now as the Cathedral is closed to the public most times.

Looking northwards I can see the long Nave, and the altar beyond. Carved on the floor just by my feet is the first of the aisle's Great Seals.

>x door
Which do I mean, the West Door, the Great Doors or the East Door?

>east
That's the door back to the Cathedral Yard.

>x west door
A smaller door leading west to another yard, and the city. It's locked, of course.

>close east door
It's not for me to go round shutting doors in this place.

>open east door
Cathedral Yard
The Yard is where we go on Saturday's for exercise, cleaning up the muck left behind by the market (worse once a month when the horse-traders from the south come up and leave presents behind for the Abbey gardens). Today it's quiet, at least, with the space between the Abbey to the east and the Cathedral to the west empty but for the usual collection of beggars, unfortunates, wretches and the disadvantaged poor.

>x door
I can't see any such thing.

>w
Great Door
Imagine an ant crawling up inside a daffodil. That's what it's like here, and this is just the Entry to the massive Cathedral further north (I guess in there you'll need to imagine an ant inside a church bell).

Let me try and do better. The main doors south are about as tall as the Abbey itself, so they need a lot of space just to fit the hinges in (those are about as big as me, I think). I came in from the Yard by the east door; there's another similar door west but it's locked right now as the Cathedral is closed to the public most times.

Looking northwards I can see the long Nave, and the altar beyond. Carved on the floor just by my feet is the first of the aisle's Great Seals.

>w
(first opening the West Door)
It's locked.

>s
(first opening the Great Doors)
You're joking, I suppose.

>unlock west door with key
That doesn't seem to fit the lock.

>n
Lower Nave
The Nave of the Cathedral is a quiet place, quieter than the Abbey because the Archbishop only allows study here and no workshops. Pews on either side are enough to seat a thousand easily, with more further north. I can't look at the ceiling (it's so high) without lying down across the Second Great Seal, and the last time I did that a monk tripped up on me and had me thrown out.

East and west are smaller shrines, and back south are the Cathedral's Great Doors.

>x seal
This one is made of brass, all wound up into a coil. It's either a spring or one of Reloh's mechanical serpents.

>n
Upper Nave
This is the north end of the Nave, where the more important people sit during services - you can tell that because the pews either side are wider and have more legroom, and each has a little cup-holder carved into its armrest. Of course, it's also closer to the Altar to the north (and further from the draught coming up from the doors to the south).

On the floor here is the Third Seal.

Rows of varnished oak pews. I'm glad I'm not a Cathedral Wood Polisher! That'd take forever.

>n
Cathedral Altar
On a dais is the main altar, representing the Celestial Workbench itself. Hanging over it as large as the setting sun is the incredible machinery of the Cathedral Clock itself.

Around the altar, a group of monks are celebrating and blessing something on the altar. I can slip away - quickly, please! - in any of the four main directions, although if I go round the dais I might have to scurry.

This is why the Abbey is so quiet, then. All the brothers are here, singing and chanting at the altar.

The monks gather in close to the Altar, as the mechanism they watch makes a sudden movement. "In Perpetuum, we Observe," a lead monk cries.

>n
Choir
To the north of the altar, this is a semi-circular space with staircases to east and west leading up to the gallery overhead. When they sing from up there - I've only heard it once - they fill the whole Cathedral with their beating rhythmic music: songs that echo round and around the dome overhead like the movement of the Greater Rotation itself.

During normal services the choir sit in the stalls on the ground level by the east staircase. They're covered in carvings just like those on the Abbey doors, but lit up in brilliant colours from the stained glass all around.

>s
Cathedral Altar
On a dais is the main altar, representing the Celestial Workbench itself. Hanging over it as large as the setting sun is the incredible machinery of the Cathedral Clock itself.

Around the altar, a group of monks are celebrating and blessing something on the altar. I can slip away - quickly, please! - in any of the four main directions, although if I go round the dais I might have to scurry.

This is why the Abbey is so quiet, then. All the brothers are here, singing and chanting at the altar.

"In Perpetuum, we Observe," the other monks reply, raising their hands and making the sign of the Penduluum in the air. "A-tempus, a-fugit," they chant.

>w
I can't go that way.

"A-tempus, a-fugit," repeats the lead monk. He steps up to the dais, and reaches with one finger to touch the side of the mechanism. All is quiet.

>n
Choir
To the north of the altar, this is a semi-circular space with staircases to east and west leading up to the gallery overhead. When they sing from up there - I've only heard it once - they fill the whole Cathedral with their beating rhythmic music: songs that echo round and around the dome overhead like the movement of the Greater Rotation itself.

During normal services the choir sit in the stalls on the ground level by the east staircase. They're covered in carvings just like those on the Abbey doors, but lit up in brilliant colours from the stained glass all around.

>w
Two rotations to reach the top. Everything in this place is designed to be correct, as carefully set as new teeth on a dog-screw.

West Clerestory

>d
Choir
To the north of the altar, this is a semi-circular space with staircases to east and west leading up to the gallery overhead. When they sing from up there - I've only heard it once - they fill the whole Cathedral with their beating rhythmic music: songs that echo round and around the dome overhead like the movement of the Greater Rotation itself.

During normal services the choir sit in the stalls on the ground level by the east staircase. They're covered in carvings just like those on the Abbey doors, but lit up in brilliant colours from the stained glass all around.

>e
(first opening the East Stairs)
Two rotations to reach the top. Everything in this place is designed to be correct, as carefully set as new teeth on a dog-screw.

East Clerestory

I beg your pardon?

* * *

>w
Two rotations to reach the top. Everything in this place is designed to be correct, as carefully set as new teeth on a dog-screw.

West Clerestory

>close stairs
That's not something I can close.

* * *

>n
Choir
To the north of the altar, this is a semi-circular space with staircases to east and west leading up to the gallery overhead. When they sing from up there - I've only heard it once - they fill the whole Cathedral with their beating rhythmic music: songs that echo round and around the dome overhead like the movement of the Greater Rotation itself.

During normal services the choir sit in the stalls on the ground level by the east staircase. They're covered in carvings just like those on the Abbey doors, but lit up in brilliant colours from the stained glass all around.

>u
You must supply a noun.

* * *

>n
Lower Nave
The Nave of the Cathedral is a quiet place, quieter than the Abbey because the Archbishop only allows study here and no workshops. Pews on either side are enough to seat a thousand easily, with more further north. I can't look at the ceiling (it's so high) without lying down across the Second Great Seal, and the last time I did that a monk tripped up on me and had me thrown out.

East and west are smaller shrines, and back south are the Cathedral's Great Doors.

>e
Shrine of the Saints
A small shrine but a packed on. Where the Abbey's got three niches for the Major Three Saints, the Cathedral has about a hundred niches for the Minor Everybody Else. Little busts and statuettes, some holding the tools of their trade, and all glaring at me for skulking around in here. The Nave is back west.

A brass stand in the middle of the room is thick with candles, all unlit. They come in three colours, same as the bruises Drake gives me; red then blue then yellow.

>x blur
I can't see any such thing.

>x blue
I see nothing special about the blue candles.

>x yellow
I see nothing special about the yellow candles.

>x red candles
I see nothing special about the red candles.

>x red candle
I see nothing special about the red candles.

>take red
They're hardly portable.

* * *

>e
Shrine of the Saints
A small shrine but a packed on. Where the Abbey's got three niches for the Major Three Saints, the Cathedral has about a hundred niches for the Minor Everybody Else. Little busts and statuettes, some holding the tools of their trade, and all glaring at me for skulking around in here. The Nave is back west.

A brass stand in the middle of the room is thick with candles, all unlit. They come in three colours, same as the bruises Drake gives me; red then blue then yellow.

>get red
I pluck a red candle from the stand.

>x red
There are several red candles on the stand, grouped together on one of the sides.

>showme
Shrine of the Saints - room
    myself - person
        Horloge's Keys
        small gear
        my lucky clock key (worn)
        rag
        tumbler - open container
    statues
    brass stand
    red candles - candle dispenser
    blue candles - candle dispenser
    yellow candles - candle dispenser

* * *

>get red
I pluck a red candle from the stand.

>get red
(the red candle)
I already have that.

>get red candles
I've already got a red candle.

>inv
I am carrying:
  a red candle
  Horloge's Keys
  a small gear
  my lucky clock key (being worn)
  a rag
  a tumbler

>get blue
I pluck a blue candle from the stand.

>get yellow
I pluck a yellow candle from the stand.

>inv
I am carrying:
  a yellow candle
  a blue candle
  a red candle
  Horloge's Keys
  a small gear
  my lucky clock key (being worn)
  a rag
  a tumbler

>x red
(the red candle)
The candle is long and thin with a thin string wick. The wax is strawberry-red.

>x yellow
(the yellow candle)
The candle is long and thin with a thin string wick. The wax is daffodil-yellow.

>x blue
(the blue candle)
The candle is long and thin with a thin string wick. The wax is sky-blue.

>x statues
I can't see any such thing.

>l
Shrine of the Saints
A small shrine but a packed on. Where the Abbey's got three niches for the Major Three Saints, the Cathedral has about a hundred niches for the Minor Everybody Else. Little busts and statuettes, some holding the tools of their trade, and all glaring at me for skulking around in here. The Nave is back west.

A brass stand in the middle of the room is thick with candles, all unlit. They come in three colours, same as the bruises Drake gives me; red then blue then yellow.

>x statuettes
St Allan, with his hexagonal key.

>x statuettes
St Cauchy, with his dividing rod.

>x statuettes
St Allan, with his hexagonal key.

>x statuettes
St Ykea, with his design manuals.

>x statuettes
St Wainwright, with his compasses.

>x statuettes
St Allan, with his hexagonal key.

>x statuettes
St Wainwright, with his compasses.

>x statuettes
St Cauchy, with his dividing rod.

>x statuettes
St Wainwright, with his compasses.

>x statuettes
St Maxwell, with his electronia.

>x statuettes
St Cauchy, with his dividing rod.

>x statuettes
St Decartes, with his set square.

* * *

>x pendulum
The penduluum is a large amount of Holy Brass, properly blessed and bevelled. It swings back and forth, raising the weight of Precision against the counterweight of Slapdashery. 

"I told you now didn't I tell you?" old Abbot Gubbler is saying, plaintively. "Here? Why here? You shouldn't have come here."

The Figure says something in reply. I can only hear two words, but they're enough to stop my heart. "Failure," and "Consequences."

>x weights
I can't see any such thing.

>x weight of precision
I only understood you as far as wanting to examine the penduluum.

>x counterweight of slapdashery
I only understood you as far as wanting to examine the penduluum.

>x figure
The glimpse I caught earlier was a tall - man? - wearing a suit of grey leather and a long flowing cape. Now I can't see him at all - it's almost as though he knows I'm hiding, and he's avoiding the keyhole's line of sight. 

"But these things, these things are not always tick-tock, they never are," the old man replies. His voice is quivering, quite different from the steady drone he has when intoning in Chapel. "The - item you asked about - it's in the Vaults, you see? The Vaults. Even if I could get in, I ..."

The Figure is too far from the keyhole and speaks too quietly for me to hear clearly. "Disappointing," he says; and then "unslip your gears."

>x abbot
I can't see much through the keyhole, except the Abbot's stout waist and shaking hands. Not much good for winding anything now, but if I said as much to anyone then I'd be in real trouble. 

The Abbot is spluttering and choking. I've seen him like this only once, when as a young initiate I dropped and smashed an altimeter right before the Archbishop was due to visit.

The Figure's quiet voice continues. I can make out; "too old to steal", "a better mechanism", "the opportunity."

The Abbot nods violently, shaking out agreement the way I might beat dirt from a duster. "My money?" he asks.

What? Steal? Money? This doesn't sound clockwise to me!

>i
You are carrying: 
  my lucky clock key (being worn)
  a rag
  a tumbler (containing:)
    a small amount of polish

There's the clink, of a pouch of golden minutes. A heavy pouch. The Figure, paying the Abbot...? Then suddenly, there's a third voice. "Sorry, Father, to interrupt, but you said..."

It's a monk of the Abbey. "Get out!" the Abbot screeches. His bearing's lost its oil, it seems. "Get out, get out!"

"But Father," the monk continues, "it's time, you know. You told me to tell you when it was time."

"Oh! Of course of course," he mumbles. "I'll... We'll continue this discussion later, then," he says, to the Figure.

The Figure intones something in reply.

The Abbot leaves, and that leaves me alone, inside this clock, with the stranger outside. He's coming nearer... I can hear his fingers on the door of the case! I must have nudged the penduluum, he must have seen the clock-hands quiver... but then, there's the swish of his cloak as he moves away, and the click as the door closes. Phew.

>put tumbler against door
I hear nothing unexpected.

>restart
Are you sure you want to restart?

>y
[The Scripted Events extension, which manages certain cut-scenes, is loaded in debugging mode. You can issue these commands:
 "scripts off" and "scripts on" to pause and resume cut-scenes.
 "scripts forward" to allow a single scripted event to occur.
 "scripts" by itself shows a summary of scheduled events.
 "scripts list" gives a full list, (may not be useful except to programmers.) ]

"HEY WREN!"

Uh-oh.

"We've got a job for you!"

"Yeah, a promotion!"

This, coming from Drake and Calvin, means something horrible is about to happen.

"You've got your rag, don't you?"

"And your polish?"

"Yes," I bleat.

"Course you do. Well, we've got something for you to do."

"Yeah," chimes Calvin.

One on each arm, they march me down the hall, towards the Abbots door. Am I in trouble? Going to be thrown out of the Cathedral?

"On three!" shouts Drake.

"Dong!" Calvin counts. "Dong! Dong!"

They shove me through the door. I fall into the Abbot's personal chamber. I might not know much about the Abbey but I do know that I really shouldn't be in here

The Shadow In The Cathedral
The Shadow In The Cathedral by Textfyre Inc
Copyright 2009 by Textfyre Inc
Designed by Ian Finley
Written by Jon Ingold
Game Engine (FyreVM) by Jesse McGrew
Inform 7 Story Programming by Graeme Jefferis
Testing by ____
User Interface Programming by Thomas Lynge
Special thanks to Graham Nelson and Emily Short
for all of their hard work on Inform 7.
All rights reserved

Abbot's Quarters
If I thought Abbots lived in luxury, then I was dead wrong. Even my attic's cosier than this. The Abbot's got no furniture at all, except a desk and a cot, and no decoration except for a bust of St. Newton. None of the axle-mounted bevelled mobiles I was expecting. There's barely even any sunlight: one thin window to catch the sun-rise, opposite the door to the hallway back east.

St. Newton is staring at the Abbot's unpolished Grandfather clock with a severe frown.

>test quarters
(Testing.)

>[1] x desk
Gubbler's desk is bare and old. The surface is scratched a little with geometric designs. 

"And don't come out till that clock's shining!" shouts Drake from the hall.

"Yeah," Calvin says. "It's got to look as good as if we did it!"

"Idiot," Drake mutters. "Come on."

Their voices disappear down the hall.

>[2] x designs
I can't see any such thing.

>[3] x scratches
I can't see any such thing.

>[4] x cot
The Abbot's cot is a hard wooden pallet, with no pillow and one small blanket. "Mustn't sleep," I can hear him saying. "Time doesn't sleep. Sleep is our great weakness." 

The grandfather clock ticks off a minute with a stately thunk. Quickly, I make the sign of the winding gear.

>[5] x blanket
The Abbot's cot is a hard wooden pallet, with no pillow and one small blanket. "Mustn't sleep," I can hear him saying. "Time doesn't sleep. Sleep is our great weakness." 

From the hallway outside comes the echo of voices. Too shaky to be Calvin or Drake. More like - oh, no. It's the Abbot, coming back to his room. And if he finds me here, then my springs won't be worth the spindles they're sprung to...

>[6] x bust
I can feel the well-fitted eyes of St. Newton gazing right down into my workings. Quickly, I make the sign of penduluum and look away. 

The Abbot's voice is getting closer. The old man may move slower than a short hand, but he's definitely coming this way.

>[7] x window
The narrow-barred window catches the morning sunshine. The same sunshine that Drake and Calvin are out enjoying while I'm stuck in here. 

Oh, widdershins! Gubbler is right outside the door! I'd better hide somewhere!

>[8] x door
(the Abbot's Door)
I see nothing special about the Abbot's Door.

"We'll talk in here," I hear the Abbot saying, from right outside the door. "More private. More quiet. Much better." The old man steps inside the room, followed by a tall figure in grey. In the last tick before his old eyes can see me, I dive inside the gigantic clock case and pull closed the door.

Inside Clock Case
As the phrase goes, I'm stuck between a rack and a gear-trace; except here I'm in the narrow gap between the clock case door and the heavy swinging penduluum behind. And if that hit me, and disrupted the holy timings... well, there's no way they wouldn't notice when the clock-hands stopped moving, let's just say.

A little light shines in through the keyhole, which is almost covered by the Abbot's spare robe.

Oh, no... That click outside was the sound of the Abbot closing the door. Looks like he - and the grey figure I glimpsed with him - are going to be here for a while...

* * *

>i
I'm carrying: 
  Horloge's keys
  a small gear
  my lucky clock key (being worn)
  a glass tumbler (which is empty)