In "Using Controls" we set out to begin using explicit control over the output from our game. The text you're reading right now is a part of the "prologue" and in Fyre Sampler will be displayed as a pop-up window. As you progress further into the game, other controls will be enabled including: menus, an inventory window, and sound.

Using Controls
An Interactive Fiction by Textfyre, Inc
Release 1 / Serial number 081214 / Inform 7 build 5U92 (I6/v6.31 lib 6/12N) SD

Hilltop
You are standing atop a small hill that clears the local forest ceiling. Off to the east you see the mist of a great river. Closer to you, there is a clearing with what appears a small white house. To the south you can see a series of buildings sticking up through the forest.

>s
Magesterial Oaks
You are standing before a perimeter of magesterial oka trees, clearly guarding a series of buildings beyond. A rusty gate blocks your path to the south and extending southeast and southwest from the gate is an iron wall.

>x gate
The gate is a tall, narrow portion of a great iron wall that stretches around the buildings spotted through openings in the forest to the south.

>s wall
I only understood you as far as wanting to s.

* * *

>x gate
The gate is a tall, narrow portion of a great iron wall that stretches around the buildings spotted through openings in the forest to the south.

>s
You can't, since the Rusty Gate is in the way.

>open gate
You open the Rusty Gate.

>s
The Broken Fountain
This is a clearing at the entry to the forest buildings. In the center of clearing is a broken and unused water fountain. You can't even make out what centerpiece once resided within the fountain.

>n
Magesterial Oaks

* * *

>s
Magesterial Oaks
You are standing before a perimeter of magesterial oka trees, clearly guarding a series of buildings beyond. A rusty gate blocks your path to the south and extending southeast and southwest from the gate is an iron wall.

>touch wall
As your hand nears the wall you see blue sparks raise up to greet your fingers. Before realizing your mistake, your hand connects and closes the now obvious electrical circuit. In the millisecond before your death you see many piles of black dust at the foot of the wall and realize you're about to join them.

    *** You have died ***

In that game you scored 0 out of a possible 0, in 2 turns.

Would you like to RESTART, RESTORE a saved game or QUIT?

* * *

>s
Magesterial Oaks
You are standing before a perimeter of magesterial oka trees, clearly guarding a series of buildings beyond. A rusty gate blocks your path to the south and extending southeast and southwest from the gate is an iron wall.

>open gate
You open the Rusty Gate.

>s
The Compass Rose Clearing
This is a clearing at the entry to the forest buildings. In the center of clearing is a broken and unused water fountain and extending out from the fountain are star points aimed in all eight cardinal directions.

>x fountain
A shambles really. It's almost as if someone was very cross with the fountain and punched it.

* * *

>s
Magesterial Oaks
You are standing before a perimeter of magesterial oka trees, clearly guarding a series of buildings beyond. A rusty gate blocks your path to the south and extending southeast and southwest from the gate is an iron wall.

>s
You can't go that way.

>open gate
That's already open.

>s
You can't go that way.

>l
Rusty Gate
A Rusty Gate guards the southern portion of the forest while a narrow path leads up a small hill.

* * *

>e
The forest offers no path in that direction.

>s
Rusty Gate
A Rusty Gate guards the southern portion of the forest while a narrow path leads up a small hill.

>x gate
You can't see any such thing.

>x rusty gate
You can't see any such thing.