This sample FyreVM game is a straight-forward Inform 7 game. We did not explicitly implement any FyreVM Channel I/O features, but we are using the implicit features. This includes the main, location, score, time, and prompt channels. As you can see in Fyre Sampler, these elements are displayed in their appropriate locations on the Windows Form.

The Basics
An Interactive Fiction by Textfyre, Inc
Release 1 / Serial number 081214 / Inform 7 build 5U92 (I6/v6.31 lib 6/12N) SD

Backyard
The backyard is east of a small white house. This side of the house has a single, boarded-up window. The yard itself is covered in a thick layer of leaves, probably blown in from the forest, which can be seen in all directions.

>open window
You try to pry it open, but someone seems to have used Frobozz Magic VLN's (Very Large Nails). Without magic, there's no hope of opening this window.

>x window
You can't see any such thing.

* * *

>open window
You try to pry it open, but someone seems to have used Frobozz Magic VLN's (Very Large Nails). Without magic, there's no hope of opening this window.

>x me
As good-looking as ever.

>x window
The window seems to be recently nailed shut.

* * *

>open window
You try to pry it open, but someone seems to have used Frobozz Magic VLN's (Very Large Nails). Without magic, there's no hope of opening this window.

>smell house
You try to get a whiff of what's inside the house and you draw back from the distinct smell of a pepper sandwich. Your stomach rumbles in response.

* * *

>x leaves
They're just leaves.

>x window
The window seems to be recently nailed shut.

>open it
That's not something you can open.

* * *

>smell window
You try to get a whiff of what's inside the house and you draw back from the distinct smell of a pepper sandwich.

>smell
You smell nothing unexpected.

* * *

>x debris
They're just leaves.

>smell
The forest debris overwhelms even your sensitive nose.

>smell house
You can't see any such thing.

* * *

>smell house
You try to get a whiff of what's inside the house and you draw back from the distinct smell of a pepper sandwich.

>smell the house
You can't see any such thing.

>smell window
The forest debris overwhelms even your sensitive nose.

>smell
The forest debris overwhelms even your sensitive nose.

* * *

>smell
The forest debris overwhelms even your sensitive nose.

>smell window
You try to get a whiff of what's inside the house and you draw back from the distinct smell of a pepper sandwich.

>smell house
You can't see any such thing.

>smell the house
You can't see any such thing.

* * *

>smell
The forest debris overwhelms even your sensitive nose.

>smell me
You smell nothing unexpected.

>smell house
You can't see any such thing.

>smell window
*** Run-time problem P7: Too many rulebooks in simultaneous use.