>test all
>--> The following tests are available:
'test walkthrough'
'test toball'
'test walk1'
'test walk2'
'test walk3'
'test Intro'
'test Market'
'test meeting'
'test adventure'
'test jail'
'test sewers'
'test rooftops'
'test blackgate'
'test hanging'
'test maidens'
'test redgate'
'test sandler'
'test moneylenders'
'test clothier'
'test armory'
'test ballgoing'
'test socializing'
'test warroom'
'test Grubbers'
'test Me'
'test Alley'
'test OuterMarketRoof'
'test NorthwestJunction'
'test GroceryStall'
'test FruitStall'
'test CandleStall'
'test RopeStall'
'test HerbStall'
'test GemStall'
'test WeaponStall'
'test LeatherStall'
'test HatStall'
'test EasternJunction'
'test PotteryStall'
'test OutsideTent'
'test InsideTent'
'test BehindTent'
'test TopofthePost'
'test GetBanana'
'test GoCommerce'
'test CommerceStreet'
'test Bakery'
'test ArmorShop'
'test Butcher'

* * *

>resatart
Please give one of the answers above.

Would you like to RESTART, RESTORE a saved game or QUIT?

* * *

>test
>--> The following tests are available:
'test walkthrough'
'test toball'
'test walk1'
'test walk2'
'test walk3'
'test Intro'
'test Market'
'test meeting'
'test adventure'
'test jail'
'test sewers'
'test rooftops'
'test blackgate'
'test hanging'
'test maidens'
'test redgate'
'test sandler'
'test moneylenders'
'test clothier'
'test armory'
'test ballgoing'
'test socializing'
'test warroom'
'test Grubbers'
'test Me'
'test Alley'
'test OuterMarketRoof'
'test NorthwestJunction'
'test GroceryStall'
'test FruitStall'
'test CandleStall'
'test RopeStall'
'test HerbStall'
'test GemStall'
'test WeaponStall'
'test LeatherStall'
'test HatStall'
'test EasternJunction'
'test PotteryStall'
'test OutsideTent'
'test InsideTent'
'test BehindTent'
'test TopofthePost'
'test GetBanana'
'test GoCommerce'
'test CommerceStreet'
'test Bakery'
'test ArmorShop'
'test Butcher'

I beg your pardon?

I beg your pardon?

* * *

>: note
I didn't understand that sentence.

>* note
I didn't understand that sentence.

>:note
I didn't understand that sentence.

* * *

>*hdsjdhsj
I didn't understand that sentence.