Chapter 2 - Bobby 

You made it.

You let out a long, shaky breath. You're safe now. Commerce Street is home to a slightly more upscale class of merchant, and business here is not quite as frantic as in Grubber's Market. Transactions tend to be calmer, more deliberate, and involve significantly more money. The Lord's Guard will be far less tolerant of a pack of armed bullies menacing the citizens of the upper class, so it's unlikely that the mercenaries will follow you here. And even if they did, there are too many streets and side alleys for them to block off your escape.

Gratefully, you remove the cloak, which was beginning to stick to your skin with all the sweat. Now it's time to pause, catch your breath, and try to figure out why they were after you in the first place.

Commerce Street
Commerce Street runs east to west, between Grubber's Market and Lord's Market. Raised sidewalks allow pedestrians to avoid the mud, horse dung, and occasional teamster's cart rumbling by. The shops here are actual buildings, spaced evenly along the avenue. Storefronts for a bakery, a butcher's shop, and an armory line the north side of the street from west to east.

* * *

Chapter 3 - Jail 

Slowly the world comes back to you. You feel something cold and hard against your cheek; something gritty and scratchy under your hand. You hear footsteps on stone, muttering voices that fade in and out. Someone laughs, a raw, cruel sound. A loud squeak, and an echoing, metallic crash. The footsteps fade away.

You open your eyes. It's still dark.

No, it's just dim. Dim light trickles in from somewhere above you.

You sit up, and a tender spot on the back of your head throbs. Red and purple splotches bloom in front of your eyes, then fade away. After a moment or two, your head clears, and you can see where you are.

Holding Cell
A dank, cramped, foul-smelling cell. A pair of ragged burlap blankets and a few lumps of filthy straw litter the floor. The door is to the north. 

A hulking shape squats in the corner, staring at you with bloodshot eyes.

* * *

>test hanging
(Testing.)

>[1] e

Lords Market
Lord's Market is packed with people from every part of the city, all of them pressing in, blocking the streets. You've never seen it this crowded before. 

There is some sort of wooden structure erected in the center of the square.

>[2] x structure
It's a raised platform, with some sort of scaffolding built over it, and a rope dangling from...

Suddenly your mouth goes dry. It's a gallows.

>[3] z
Time passes.

A man steps up onto the wooden platform. By squeezing between two spectators and craning your neck, you can just make out that it is Baron Fossville addressing the crowd.

"Citizens of Toresal," he shouts, "as Lord of this City, it is my duty to administer justice within its gates, and punish those who transgress against the Queen's Law. More often than not, this duty is a heavy burden. Though I may wish to be lenient, consideration for the sanctity of the law and the safety of the Queen's subjects must always outweigh my softer instincts. Today, this burden weighs particularly upon me, for today I must administer the most stringent punishment allowed by the law."

Soldiers prod a second man up onto the platform. The black bag covers his face, but you recognize him by the clothes he's wearing - it's Bobby!

>[4] z
Time passes.

"This man before you stands accused of plotting high treason against the city of Toresal," shouts the Baron. "The evidence against him has been weighed, and he has been found guilty by the Honorable Magistrate Hester Rudup."

Fossville gestures to a third man standing on his other side, a gaunt man wearing crimson robes - the man who captured you last night at the fountain.

>[5] z
Time passes.

"Despite the grief it causes me, the penalty for this most heinous crime is clear." Fossville pauses; the crowd is hanging on his every word. "By the power invested in me and in accordance with the Queen's Law... I hereby sentence this man to hang by the neck until dead."

The Baron turns to one of his soldiers at the platform's base and nods his head.

Later, you cannot remember whether you really heard the clunk of the trapdoor falling open, the rope snapping taut, or whether you only imagined it. You remember screaming, clawing at the spectators in front of you, and being pushed back by rough, angry hands. You stumbled and fell onto the cobblestones. You never saw his body drop.

Everything goes black.

Please press SPACE to continue.

Chapter 7 - Mercenaries 

You are lying on something soft. Blankets, a thin mattress - you're back in Maiden House, lying in your own bunk. Fiona is sitting on the edge of the bed, watching you with a tender expression. Her eyes are red and raw, though, like she's been crying. For a moment, you feel strange, disconnected. You wonder what's wrong.

And then it comes back to you. It's Bobby. Bobby is dead.

You feel like there's something important you should say to Fiona, but you can't think of what it is.

1. "How did I get here?"
2. "I'm sorry I snuck out."
3. "Bobby is dead. They killed Bobby."

* * *

>test clothier
(Testing.)

>[1] ne
Pieter sticks close to you, looking around warily.

A small bell above the door tinkles as you enter, and a man comes rushing out of the store's back room with a measuring cord in his hands, held up as though ready to begin fitting you immediately. When he sees that you are a clean, respectable, and evidently well-to-do young lady, he practically squeals with delight, clapping his hands and plucking at the fabric of your clothes with soft, nimble fingers.

Royal Tunic
The walls are hung with tasteful curtains, and a deep, soft carpet covers the floor. Several clothier's dummies stand about the room, displaying gorgeous formal court apparel for both men and women. The street lies west.

Pieter is here, shifting his feet impatiently

The clothier hovers nearby, waiting to serve.

The clothier inspects his fingernails.

>[2] buy ballgown
After several agonizing minutes of indecision, you point to the dress you want.

The clothier flutters his hands and practically giggles, "Oh, a splendid choice! You'll look like a princess!" He dances around you, taking measurements with his cord and muttering numbers to himself as he goes. Then he takes the dress off its dummy and retreats with it into the back of his shop. "This will be just a moment," he calls over his shoulder.

You look at Pieter and shrug.

"Er, I'll wait outside," he says.

And afterwards, as you look at yourself in the full-length mirror while the clothier kneels at your feet, tugging, plucking, pinning, making adjustments, you realize that he was right - you do look like a princess.

The clothier absentmindedly flicks a bit of lint off of his sleeve.

>[3] sw
"Come back soon, sweetie," calls the clothier as you leave.

Lords Market
Lord's Market is the high-class mirror to Grubber's Market: a wide, cobbled square, uncrowded and clean, shaded by tall buildings on either side. Here Toresal's upper crust can hunt for bargains inaccessible to the ordinary rabble. Antiques, custom jewelry, and similarly high-priced goods are available behind the tasteful shopfronts. A fine clothier's, a jewelry store, and a moneylender's shop lie northeast, east, and southeast, respectively; you can return to Commerce Street to the west; and an alley leads south. 

Pieter is here, looking around warily

Pieter blinks and does a double take as you step out onto the sidewalk in your new finery. "Wow," he stammers. "You look... different. I mean, you looked good before, er, with the other dress, I mean, but this is... wow." He blushes, then grins, then shakes his head. "Come on, Lady Toresal. We still have much to do."

* * *

Chapter 11 - Baron Fossville 

The mercenaries march you out of the ballroom, through the foyer, and into the inner reaches of the keep. At every doorway you pass a pair of Lord's Guards standing at attention; some of them glare at the ill-kempt and ill-disciplined mercenaries, but no one makes a move to stop them or help you. You are keenly aware of the dagger strapped to your leg under your dress, but there seems to be no opportunity to use it. Not that you'd last very long against a half-dozen armed men anyway.

The last door is not guarded. The mercenaries push you through into a room filled with dim, flickering light.

War Room
A fireplace lights this grim chamber with a hellish, red glow. A huge, round table sits in the center of the room. Hanging opposite the fireplace is a vast map of Miradania, covering nearly the entire wall. An iron-reinforced door leads east.

Pieter is lying on the floor in front of the fire place, trussed up and gagged.

The mercenaries stand nearby, watching your every move.

Someone steps out of the shadows and walks over to stand between you and Pieter. The fire throws his shadow across the length of the room, huge and quivering.

"You know, it's funny," says Baron Fossville, "when I first began planning this venture, I always assumed that you would be the easiest obstacle to take care of."